barcode	position
GTTGATATCCTGGCCTTGGGCCGCCCCAGCGTGGCGCGGGCCCGCCCCCCGCGCCGCCAACCGAGGGCGCCGTCGAGCCGCGGGCCCCCCCCTGGCTCGCAGCGGACGGGCCAGCCAGGGCGGCCTCGGGCACCGTACTCTGCCCGGTGTGG	Cassette1_1
TTTGATATCCTGGCCTTGGGCCGCCCCAGCGTGGCGCGGGCCCGCCCCCCGCGCCGCCAACCGAGGGCGCCGTCGAGCCGCGGGCCCCCCCCTGGCTCGCAGCGGACGGGCCAGCCAGGGCGGCCTCGGGCACCGTACTCTGCCCGGTGTGG	Cassette1_1
CGCGCTATCCTGGCCTTGGGCCGCCCCAGCGTGGCGCGGGCCCGCCCCCCGCGCCGCCAACCGAGGGCGCCGTCGAGCCGCGGGCCCCCCCCTGGCTCGCAGCGGACGGGCCAGCCAGGGCGGCCTCGGGCACCGTACTCTGCCCGGTGTGG	Cassette1_2
CTCGCTATCCTGGCCTTGGGCCGCCCCAGCGTGGCGCGGGCCCGCCCCCCGCGCCGCCAACCGAGGGCGCCGTCGAGCCGCGGGCCCCCCCCTGGCTCGCAGCGGACGGGCCAGCCAGGGCGGCCTCGGGCACCGTACTCTGCCCGGTGTGG	Cassette1_2
CCGGACATCCTGGCCTTGGGCCGCCCCAGCGTGGCGCGGGCCCGCCCCCCGCGCCGCCAACCGAGGGCGCCGTCGAGCCGCGGGCCCCCCCCTGGCTCGCAGCGGACGGGCCAGCCAGGGCGGCCTCGGGCACCGTACTCTGCCCGGTGTGG	Cassette1_3
CCTGACATCCTGGCCTTGGGCCGCCCCAGCGTGGCGCGGGCCCGCCCCCCGCGCCGCCAACCGAGGGCGCCGTCGAGCCGCGGGCCCCCCCCTGGCTCGCAGCGGACGGGCCAGCCAGGGCGGCCTCGGGCACCGTACTCTGCCCGGTGTGG	Cassette1_3
ACTGCTATCCTGGCCTTGGGCCGCCCCAGCGTGGCGCGGGCCCGCCCCCCGCGCCGCCAACCGAGGGCGCCGTCGAGCCGCGGGCCCCCCCCTGGCTCGCAGCGGACGGGCCAGCCAGGGCGGCCTCGGGCACCGTACTCTGCCCGGTGTGG	Cassette1_4
ACTTCTATCCTGGCCTTGGGCCGCCCCAGCGTGGCGCGGGCCCGCCCCCCGCGCCGCCAACCGAGGGCGCCGTCGAGCCGCGGGCCCCCCCCTGGCTCGCAGCGGACGGGCCAGCCAGGGCGGCCTCGGGCACCGTACTCTGCCCGGTGTGG	Cassette1_4
ATCGGCATCCTGGCCTTGGGCCGCCCCAGCGTGGCGCGGGCCCGCCCCCCGCGCCGCCAACCGAGGGCGCCGTCGAGCCGCGGGCCCCCCCCTGGCTCGCAGCGGACGGGCCAGCCAGGGCGGCCTCGGGCACCGTACTCTGCCCGGTGTGG	Cassette1_5
ATCGTCATCCTGGCCTTGGGCCGCCCCAGCGTGGCGCGGGCCCGCCCCCCGCGCCGCCAACCGAGGGCGCCGTCGAGCCGCGGGCCCCCCCCTGGCTCGCAGCGGACGGGCCAGCCAGGGCGGCCTCGGGCACCGTACTCTGCCCGGTGTGG	Cassette1_5
CCTGCGTTCCTGGCCTTGGGCCGCCCCAGCGTGGCGCGGGCCCGCCCCCCGCGCCGCCAACCGAGGGCGCCGTCGAGCCGCGGGCCCCCCCCTGGCTCGCAGCGGACGGGCCAGCCAGGGCGGCCTCGGGCACCGTACTCTGCCCGGTGTGG	Cassette1_6
CCTGCTTTCCTGGCCTTGGGCCGCCCCAGCGTGGCGCGGGCCCGCCCCCCGCGCCGCCAACCGAGGGCGCCGTCGAGCCGCGGGCCCCCCCCTGGCTCGCAGCGGACGGGCCAGCCAGGGCGGCCTCGGGCACCGTACTCTGCCCGGTGTGG	Cassette1_6
CCTGATGACCTGGCCTTGGGCCGCCCCAGCGTGGCGCGGGCCCGCCCCCCGCGCCGCCAACCGAGGGCGCCGTCGAGCCGCGGGCCCCCCCCTGGCTCGCAGCGGACGGGCCAGCCAGGGCGGCCTCGGGCACCGTACTCTGCCCGGTGTGG	Cassette1_7
CCTGATTACCTGGCCTTGGGCCGCCCCAGCGTGGCGCGGGCCCGCCCCCCGCGCCGCCAACCGAGGGCGCCGTCGAGCCGCGGGCCCCCCCCTGGCTCGCAGCGGACGGGCCAGCCAGGGCGGCCTCGGGCACCGTACTCTGCCCGGTGTGG	Cassette1_7
CTTGCCAGCCTGGCCTTGGGCCGCCCCAGCGTGGCGCGGGCCCGCCCCCCGCGCCGCCAACCGAGGGCGCCGTCGAGCCGCGGGCCCCCCCCTGGCTCGCAGCGGACGGGCCAGCCAGGGCGGCCTCGGGCACCGTACTCTGCCCGGTGTGG	Cassette1_8
CTTGCCATCCTGGCCTTGGGCCGCCCCAGCGTGGCGCGGGCCCGCCCCCCGCGCCGCCAACCGAGGGCGCCGTCGAGCCGCGGGCCCCCCCCTGGCTCGCAGCGGACGGGCCAGCCAGGGCGGCCTCGGGCACCGTACTCTGCCCGGTGTGG	Cassette1_8
ACCGATATGAAGGCCTTGGGCCGCCCCAGCGTGGCGCGGGCCCGCCCCCCGCGCCGCCAACCGAGGGCGCCGTCGAGCCGCGGGCCCCCCCCTGGCTCGCAGCGGACGGGCCAGCCAGGGCGGCCTCGGGCACCGTACTCTGCCCGGTGTGG	Cassette2_1
ACCGATATTAAGGCCTTGGGCCGCCCCAGCGTGGCGCGGGCCCGCCCCCCGCGCCGCCAACCGAGGGCGCCGTCGAGCCGCGGGCCCCCCCCTGGCTCGCAGCGGACGGGCCAGCCAGGGCGGCCTCGGGCACCGTACTCTGCCCGGTGTGG	Cassette2_1
ACCGATATTGTCGCCTTGGGCCGCCCCAGCGTGGCGCGGGCCCGCCCCCCGCGCCGCCAACCGAGGGCGCCGTCGAGCCGCGGGCCCCCCCCTGGCTCGCAGCGGACGGGCCAGCCAGGGCGGCCTCGGGCACCGTACTCTGCCCGGTGTGG	Cassette2_2
ACCGATATTTTCGCCTTGGGCCGCCCCAGCGTGGCGCGGGCCCGCCCCCCGCGCCGCCAACCGAGGGCGCCGTCGAGCCGCGGGCCCCCCCCTGGCTCGCAGCGGACGGGCCAGCCAGGGCGGCCTCGGGCACCGTACTCTGCCCGGTGTGG	Cassette2_2
ACCGATATTCGGACCTTGGGCCGCCCCAGCGTGGCGCGGGCCCGCCCCCCGCGCCGCCAACCGAGGGCGCCGTCGAGCCGCGGGCCCCCCCCTGGCTCGCAGCGGACGGGCCAGCCAGGGCGGCCTCGGGCACCGTACTCTGCCCGGTGTGG	Cassette2_3
ACCGATATTCTGACCTTGGGCCGCCCCAGCGTGGCGCGGGCCCGCCCCCCGCGCCGCCAACCGAGGGCGCCGTCGAGCCGCGGGCCCCCCCCTGGCTCGCAGCGGACGGGCCAGCCAGGGCGGCCTCGGGCACCGTACTCTGCCCGGTGTGG	Cassette2_3
ACCGATATCATGACCTTGGGCCGCCCCAGCGTGGCGCGGGCCCGCCCCCCGCGCCGCCAACCGAGGGCGCCGTCGAGCCGCGGGCCCCCCCCTGGCTCGCAGCGGACGGGCCAGCCAGGGCGGCCTCGGGCACCGTACTCTGCCCGGTGTGG	Cassette2_4
ACCGATATCATTACCTTGGGCCGCCCCAGCGTGGCGCGGGCCCGCCCCCCGCGCCGCCAACCGAGGGCGCCGTCGAGCCGCGGGCCCCCCCCTGGCTCGCAGCGGACGGGCCAGCCAGGGCGGCCTCGGGCACCGTACTCTGCCCGGTGTGG	Cassette2_4
ACCGATATCCACGCCTTGGGCCGCCCCAGCGTGGCGCGGGCCCGCCCCCCGCGCCGCCAACCGAGGGCGCCGTCGAGCCGCGGGCCCCCCCCTGGCTCGCAGCGGACGGGCCAGCCAGGGCGGCCTCGGGCACCGTACTCTGCCCGGTGTGG	Cassette2_5
ACCGATATCCACTCCTTGGGCCGCCCCAGCGTGGCGCGGGCCCGCCCCCCGCGCCGCCAACCGAGGGCGCCGTCGAGCCGCGGGCCCCCCCCTGGCTCGCAGCGGACGGGCCAGCCAGGGCGGCCTCGGGCACCGTACTCTGCCCGGTGTGG	Cassette2_5
ACCGATATTAACAGCTTGGGCCGCCCCAGCGTGGCGCGGGCCCGCCCCCCGCGCCGCCAACCGAGGGCGCCGTCGAGCCGCGGGCCCCCCCCTGGCTCGCAGCGGACGGGCCAGCCAGGGCGGCCTCGGGCACCGTACTCTGCCCGGTGTGG	Cassette2_6
ACCGATATTAACATCTTGGGCCGCCCCAGCGTGGCGCGGGCCCGCCCCCCGCGCCGCCAACCGAGGGCGCCGTCGAGCCGCGGGCCCCCCCCTGGCTCGCAGCGGACGGGCCAGCCAGGGCGGCCTCGGGCACCGTACTCTGCCCGGTGTGG	Cassette2_6
ACCGATATTATGAAGTTGGGCCGCCCCAGCGTGGCGCGGGCCCGCCCCCCGCGCCGCCAACCGAGGGCGCCGTCGAGCCGCGGGCCCCCCCCTGGCTCGCAGCGGACGGGCCAGCCAGGGCGGCCTCGGGCACCGTACTCTGCCCGGTGTGG	Cassette2_7
ACCGATATTATGAATTTGGGCCGCCCCAGCGTGGCGCGGGCCCGCCCCCCGCGCCGCCAACCGAGGGCGCCGTCGAGCCGCGGGCCCCCCCCTGGCTCGCAGCGGACGGGCCAGCCAGGGCGGCCTCGGGCACCGTACTCTGCCCGGTGTGG	Cassette2_7
ACCGATATTCACGACGTGGGCCGCCCCAGCGTGGCGCGGGCCCGCCCCCCGCGCCGCCAACCGAGGGCGCCGTCGAGCCGCGGGCCCCCCCCTGGCTCGCAGCGGACGGGCCAGCCAGGGCGGCCTCGGGCACCGTACTCTGCCCGGTGTGG	Cassette2_8
ACCGATATTCACGACTTGGGCCGCCCCAGCGTGGCGCGGGCCCGCCCCCCGCGCCGCCAACCGAGGGCGCCGTCGAGCCGCGGGCCCCCCCCTGGCTCGCAGCGGACGGGCCAGCCAGGGCGGCCTCGGGCACCGTACTCTGCCCGGTGTGG	Cassette2_8
ACCGATATCCTGGCCTGGAGACGCCCCAGCGTGGCGCGGGCCCGCCCCCCGCGCCGCCAACCGAGGGCGCCGTCGAGCCGCGGGCCCCCCCCTGGCTCGCAGCGGACGGGCCAGCCAGGGCGGCCTCGGGCACCGTACTCTGCCCGGTGTGG	Cassette3_1
ACCGATATCCTGGCCTTGAGACGCCCCAGCGTGGCGCGGGCCCGCCCCCCGCGCCGCCAACCGAGGGCGCCGTCGAGCCGCGGGCCCCCCCCTGGCTCGCAGCGGACGGGCCAGCCAGGGCGGCCTCGGGCACCGTACTCTGCCCGGTGTGG	Cassette3_1
ACCGATATCCTGGCCTAGAGCTGCCCCAGCGTGGCGCGGGCCCGCCCCCCGCGCCGCCAACCGAGGGCGCCGTCGAGCCGCGGGCCCCCCCCTGGCTCGCAGCGGACGGGCCAGCCAGGGCGGCCTCGGGCACCGTACTCTGCCCGGTGTGG	Cassette3_2
ACCGATATCCTGGCCTATAGCTGCCCCAGCGTGGCGCGGGCCCGCCCCCCGCGCCGCCAACCGAGGGCGCCGTCGAGCCGCGGGCCCCCCCCTGGCTCGCAGCGGACGGGCCAGCCAGGGCGGCCTCGGGCACCGTACTCTGCCCGGTGTGG	Cassette3_2
ACCGATATCCTGGCCTAGGGATACCCCAGCGTGGCGCGGGCCCGCCCCCCGCGCCGCCAACCGAGGGCGCCGTCGAGCCGCGGGCCCCCCCCTGGCTCGCAGCGGACGGGCCAGCCAGGGCGGCCTCGGGCACCGTACTCTGCCCGGTGTGG	Cassette3_3
ACCGATATCCTGGCCTAGTGATACCCCAGCGTGGCGCGGGCCCGCCCCCCGCGCCGCCAACCGAGGGCGCCGTCGAGCCGCGGGCCCCCCCCTGGCTCGCAGCGGACGGGCCAGCCAGGGCGGCCTCGGGCACCGTACTCTGCCCGGTGTGG	Cassette3_3
ACCGATATCCTGGCCTTGGGATGCCCCAGCGTGGCGCGGGCCCGCCCCCCGCGCCGCCAACCGAGGGCGCCGTCGAGCCGCGGGCCCCCCCCTGGCTCGCAGCGGACGGGCCAGCCAGGGCGGCCTCGGGCACCGTACTCTGCCCGGTGTGG	Cassette3_4
ACCGATATCCTGGCCTTGGTATGCCCCAGCGTGGCGCGGGCCCGCCCCCCGCGCCGCCAACCGAGGGCGCCGTCGAGCCGCGGGCCCCCCCCTGGCTCGCAGCGGACGGGCCAGCCAGGGCGGCCTCGGGCACCGTACTCTGCCCGGTGTGG	Cassette3_4
ACCGATATCCTGGCCTAGAGGCATCCCAGCGTGGCGCGGGCCCGCCCCCCGCGCCGCCAACCGAGGGCGCCGTCGAGCCGCGGGCCCCCCCCTGGCTCGCAGCGGACGGGCCAGCCAGGGCGGCCTCGGGCACCGTACTCTGCCCGGTGTGG	Cassette3_5
ACCGATATCCTGGCCTAGAGTCATCCCAGCGTGGCGCGGGCCCGCCCCCCGCGCCGCCAACCGAGGGCGCCGTCGAGCCGCGGGCCCCCCCCTGGCTCGCAGCGGACGGGCCAGCCAGGGCGGCCTCGGGCACCGTACTCTGCCCGGTGTGG	Cassette3_5
ACCGATATCCTGGCCTTGAGCGACCCCAGCGTGGCGCGGGCCCGCCCCCCGCGCCGCCAACCGAGGGCGCCGTCGAGCCGCGGGCCCCCCCCTGGCTCGCAGCGGACGGGCCAGCCAGGGCGGCCTCGGGCACCGTACTCTGCCCGGTGTGG	Cassette3_6
ACCGATATCCTGGCCTTGAGCTACCCCAGCGTGGCGCGGGCCCGCCCCCCGCGCCGCCAACCGAGGGCGCCGTCGAGCCGCGGGCCCCCCCCTGGCTCGCAGCGGACGGGCCAGCCAGGGCGGCCTCGGGCACCGTACTCTGCCCGGTGTGG	Cassette3_6
ACCGATATCCTGGCCTAGGGCTGTCCCAGCGTGGCGCGGGCCCGCCCCCCGCGCCGCCAACCGAGGGCGCCGTCGAGCCGCGGGCCCCCCCCTGGCTCGCAGCGGACGGGCCAGCCAGGGCGGCCTCGGGCACCGTACTCTGCCCGGTGTGG	Cassette3_7
ACCGATATCCTGGCCTAGGGCTTTCCCAGCGTGGCGCGGGCCCGCCCCCCGCGCCGCCAACCGAGGGCGCCGTCGAGCCGCGGGCCCCCCCCTGGCTCGCAGCGGACGGGCCAGCCAGGGCGGCCTCGGGCACCGTACTCTGCCCGGTGTGG	Cassette3_7
ACCGATATCCTGGCCTTGGGACAGCCCAGCGTGGCGCGGGCCCGCCCCCCGCGCCGCCAACCGAGGGCGCCGTCGAGCCGCGGGCCCCCCCCTGGCTCGCAGCGGACGGGCCAGCCAGGGCGGCCTCGGGCACCGTACTCTGCCCGGTGTGG	Cassette3_8
ACCGATATCCTGGCCTTGGGACATCCCAGCGTGGCGCGGGCCCGCCCCCCGCGCCGCCAACCGAGGGCGCCGTCGAGCCGCGGGCCCCCCCCTGGCTCGCAGCGGACGGGCCAGCCAGGGCGGCCTCGGGCACCGTACTCTGCCCGGTGTGG	Cassette3_8
ACCGATATCCTGGCCTTGGGCCGCGTAAGCGTGGCGCGGGCCCGCCCCCCGCGCCGCCAACCGAGGGCGCCGTCGAGCCGCGGGCCCCCCCCTGGCTCGCAGCGGACGGGCCAGCCAGGGCGGCCTCGGGCACCGTACTCTGCCCGGTGTGG	Cassette4_1
ACCGATATCCTGGCCTTGGGCCGCTTAAGCGTGGCGCGGGCCCGCCCCCCGCGCCGCCAACCGAGGGCGCCGTCGAGCCGCGGGCCCCCCCCTGGCTCGCAGCGGACGGGCCAGCCAGGGCGGCCTCGGGCACCGTACTCTGCCCGGTGTGG	Cassette4_1
ACCGATATCCTGGCCTTGGGCCGCTGCTGCGTGGCGCGGGCCCGCCCCCCGCGCCGCCAACCGAGGGCGCCGTCGAGCCGCGGGCCCCCCCCTGGCTCGCAGCGGACGGGCCAGCCAGGGCGGCCTCGGGCACCGTACTCTGCCCGGTGTGG	Cassette4_2
ACCGATATCCTGGCCTTGGGCCGCTTCTGCGTGGCGCGGGCCCGCCCCCCGCGCCGCCAACCGAGGGCGCCGTCGAGCCGCGGGCCCCCCCCTGGCTCGCAGCGGACGGGCCAGCCAGGGCGGCCTCGGGCACCGTACTCTGCCCGGTGTGG	Cassette4_2
ACCGATATCCTGGCCTTGGGCCGCCTGTACGTGGCGCGGGCCCGCCCCCCGCGCCGCCAACCGAGGGCGCCGTCGAGCCGCGGGCCCCCCCCTGGCTCGCAGCGGACGGGCCAGCCAGGGCGGCCTCGGGCACCGTACTCTGCCCGGTGTGG	Cassette4_3
ACCGATATCCTGGCCTTGGGCCGCCTTTACGTGGCGCGGGCCCGCCCCCCGCGCCGCCAACCGAGGGCGCCGTCGAGCCGCGGGCCCCCCCCTGGCTCGCAGCGGACGGGCCAGCCAGGGCGGCCTCGGGCACCGTACTCTGCCCGGTGTGG	Cassette4_3
ACCGATATCCTGGCCTTGGGCCGCTCAGACGTGGCGCGGGCCCGCCCCCCGCGCCGCCAACCGAGGGCGCCGTCGAGCCGCGGGCCCCCCCCTGGCTCGCAGCGGACGGGCCAGCCAGGGCGGCCTCGGGCACCGTACTCTGCCCGGTGTGG	Cassette4_4
ACCGATATCCTGGCCTTGGGCCGCTCATACGTGGCGCGGGCCCGCCCCCCGCGCCGCCAACCGAGGGCGCCGTCGAGCCGCGGGCCCCCCCCTGGCTCGCAGCGGACGGGCCAGCCAGGGCGGCCTCGGGCACCGTACTCTGCCCGGTGTGG	Cassette4_4
ACCGATATCCTGGCCTTGGGCCGCCTCAGAGTGGCGCGGGCCCGCCCCCCGCGCCGCCAACCGAGGGCGCCGTCGAGCCGCGGGCCCCCCCCTGGCTCGCAGCGGACGGGCCAGCCAGGGCGGCCTCGGGCACCGTACTCTGCCCGGTGTGG	Cassette4_5
ACCGATATCCTGGCCTTGGGCCGCCTCATAGTGGCGCGGGCCCGCCCCCCGCGCCGCCAACCGAGGGCGCCGTCGAGCCGCGGGCCCCCCCCTGGCTCGCAGCGGACGGGCCAGCCAGGGCGGCCTCGGGCACCGTACTCTGCCCGGTGTGG	Cassette4_5
ACCGATATCCTGGCCTTGGGCCGCCCATGGGTGGCGCGGGCCCGCCCCCCGCGCCGCCAACCGAGGGCGCCGTCGAGCCGCGGGCCCCCCCCTGGCTCGCAGCGGACGGGCCAGCCAGGGCGGCCTCGGGCACCGTACTCTGCCCGGTGTGG	Cassette4_6
ACCGATATCCTGGCCTTGGGCCGCCCATGTGTGGCGCGGGCCCGCCCCCCGCGCCGCCAACCGAGGGCGCCGTCGAGCCGCGGGCCCCCCCCTGGCTCGCAGCGGACGGGCCAGCCAGGGCGGCCTCGGGCACCGTACTCTGCCCGGTGTGG	Cassette4_6
ACCGATATCCTGGCCTTGGGCCGCTTCAACGTGGCGCGGGCCCGCCCCCCGCGCCGCCAACCGAGGGCGCCGTCGAGCCGCGGGCCCCCCCCTGGCTCGCAGCGGACGGGCCAGCCAGGGCGGCCTCGGGCACCGTACTCTGCCCGGTGTGG	Cassette4_7
ACCGATATCCTGGCCTTGGGCCGCTTCAACTTGGCGCGGGCCCGCCCCCCGCGCCGCCAACCGAGGGCGCCGTCGAGCCGCGGGCCCCCCCCTGGCTCGCAGCGGACGGGCCAGCCAGGGCGGCCTCGGGCACCGTACTCTGCCCGGTGTGG	Cassette4_7
ACCGATATCCTGGCCTTGGGCCGCCCCTAAGGGGCGCGGGCCCGCCCCCCGCGCCGCCAACCGAGGGCGCCGTCGAGCCGCGGGCCCCCCCCTGGCTCGCAGCGGACGGGCCAGCCAGGGCGGCCTCGGGCACCGTACTCTGCCCGGTGTGG	Cassette4_8
ACCGATATCCTGGCCTTGGGCCGCCCCTAAGTGGCGCGGGCCCGCCCCCCGCGCCGCCAACCGAGGGCGCCGTCGAGCCGCGGGCCCCCCCCTGGCTCGCAGCGGACGGGCCAGCCAGGGCGGCCTCGGGCACCGTACTCTGCCCGGTGTGG	Cassette4_8
ACCGATATCCTGGCCTTGGGCCGCCCCAGCGTGCTGCGGGCCCGCCCCCCGCGCCGCCAACCGAGGGCGCCGTCGAGCCGCGGGCCCCCCCCTGGCTCGCAGCGGACGGGCCAGCCAGGGCGGCCTCGGGCACCGTACTCTGCCCGGTGTGG	Cassette5_1
ACCGATATCCTGGCCTTGGGCCGCCCCAGCGTTCTGCGGGCCCGCCCCCCGCGCCGCCAACCGAGGGCGCCGTCGAGCCGCGGGCCCCCCCCTGGCTCGCAGCGGACGGGCCAGCCAGGGCGGCCTCGGGCACCGTACTCTGCCCGGTGTGG	Cassette5_1
ACCGATATCCTGGCCTTGGGCCGCCCCAGCGTAGCACGGGCCCGCCCCCCGCGCCGCCAACCGAGGGCGCCGTCGAGCCGCGGGCCCCCCCCTGGCTCGCAGCGGACGGGCCAGCCAGGGCGGCCTCGGGCACCGTACTCTGCCCGGTGTGG	Cassette5_2
ACCGATATCCTGGCCTTGGGCCGCCCCAGCGTATCACGGGCCCGCCCCCCGCGCCGCCAACCGAGGGCGCCGTCGAGCCGCGGGCCCCCCCCTGGCTCGCAGCGGACGGGCCAGCCAGGGCGGCCTCGGGCACCGTACTCTGCCCGGTGTGG	Cassette5_2
ACCGATATCCTGGCCTTGGGCCGCCCCAGCGTAGGGTGGGCCCGCCCCCCGCGCCGCCAACCGAGGGCGCCGTCGAGCCGCGGGCCCCCCCCTGGCTCGCAGCGGACGGGCCAGCCAGGGCGGCCTCGGGCACCGTACTCTGCCCGGTGTGG	Cassette5_3
ACCGATATCCTGGCCTTGGGCCGCCCCAGCGTAGTGTGGGCCCGCCCCCCGCGCCGCCAACCGAGGGCGCCGTCGAGCCGCGGGCCCCCCCCTGGCTCGCAGCGGACGGGCCAGCCAGGGCGGCCTCGGGCACCGTACTCTGCCCGGTGTGG	Cassette5_3
ACCGATATCCTGGCCTTGGGCCGCCCCAGCGTGCCGTGGGCCCGCCCCCCGCGCCGCCAACCGAGGGCGCCGTCGAGCCGCGGGCCCCCCCCTGGCTCGCAGCGGACGGGCCAGCCAGGGCGGCCTCGGGCACCGTACTCTGCCCGGTGTGG	Cassette5_4
ACCGATATCCTGGCCTTGGGCCGCCCCAGCGTGCCTTGGGCCCGCCCCCCGCGCCGCCAACCGAGGGCGCCGTCGAGCCGCGGGCCCCCCCCTGGCTCGCAGCGGACGGGCCAGCCAGGGCGGCCTCGGGCACCGTACTCTGCCCGGTGTGG	Cassette5_4
ACCGATATCCTGGCCTTGGGCCGCCCCAGCGTGGTAGGGGCCCGCCCCCCGCGCCGCCAACCGAGGGCGCCGTCGAGCCGCGGGCCCCCCCCTGGCTCGCAGCGGACGGGCCAGCCAGGGCGGCCTCGGGCACCGTACTCTGCCCGGTGTGG	Cassette5_5
ACCGATATCCTGGCCTTGGGCCGCCCCAGCGTGGTATGGGCCCGCCCCCCGCGCCGCCAACCGAGGGCGCCGTCGAGCCGCGGGCCCCCCCCTGGCTCGCAGCGGACGGGCCAGCCAGGGCGGCCTCGGGCACCGTACTCTGCCCGGTGTGG	Cassette5_5
ACCGATATCCTGGCCTTGGGCCGCCCCAGCGTACTATGGGCCCGCCCCCCGCGCCGCCAACCGAGGGCGCCGTCGAGCCGCGGGCCCCCCCCTGGCTCGCAGCGGACGGGCCAGCCAGGGCGGCCTCGGGCACCGTACTCTGCCCGGTGTGG	Cassette5_6
ACCGATATCCTGGCCTTGGGCCGCCCCAGCGTACTATTGGCCCGCCCCCCGCGCCGCCAACCGAGGGCGCCGTCGAGCCGCGGGCCCCCCCCTGGCTCGCAGCGGACGGGCCAGCCAGGGCGGCCTCGGGCACCGTACTCTGCCCGGTGTGG	Cassette5_6
ACCGATATCCTGGCCTTGGGCCGCCCCAGCGTACCGCAGGCCCGCCCCCCGCGCCGCCAACCGAGGGCGCCGTCGAGCCGCGGGCCCCCCCCTGGCTCGCAGCGGACGGGCCAGCCAGGGCGGCCTCGGGCACCGTACTCTGCCCGGTGTGG	Cassette5_7
ACCGATATCCTGGCCTTGGGCCGCCCCAGCGTACCGCATGCCCGCCCCCCGCGCCGCCAACCGAGGGCGCCGTCGAGCCGCGGGCCCCCCCCTGGCTCGCAGCGGACGGGCCAGCCAGGGCGGCCTCGGGCACCGTACTCTGCCCGGTGTGG	Cassette5_7
ACCGATATCCTGGCCTTGGGCCGCCCCAGCGTAGTGCAGGCCCGCCCCCCGCGCCGCCAACCGAGGGCGCCGTCGAGCCGCGGGCCCCCCCCTGGCTCGCAGCGGACGGGCCAGCCAGGGCGGCCTCGGGCACCGTACTCTGCCCGGTGTGG	Cassette5_8
ACCGATATCCTGGCCTTGGGCCGCCCCAGCGTAGTGCAGTCCCGCCCCCCGCGCCGCCAACCGAGGGCGCCGTCGAGCCGCGGGCCCCCCCCTGGCTCGCAGCGGACGGGCCAGCCAGGGCGGCCTCGGGCACCGTACTCTGCCCGGTGTGG	Cassette5_8
ACCGATATCCTGGCCTTGGGCCGCCCCAGCGTGGCGCGGGGATGCCCCCCGCGCCGCCAACCGAGGGCGCCGTCGAGCCGCGGGCCCCCCCCTGGCTCGCAGCGGACGGGCCAGCCAGGGCGGCCTCGGGCACCGTACTCTGCCCGGTGTGG	Cassette6_1
ACCGATATCCTGGCCTTGGGCCGCCCCAGCGTGGCGCGGGTATGCCCCCCGCGCCGCCAACCGAGGGCGCCGTCGAGCCGCGGGCCCCCCCCTGGCTCGCAGCGGACGGGCCAGCCAGGGCGGCCTCGGGCACCGTACTCTGCCCGGTGTGG	Cassette6_1
ACCGATATCCTGGCCTTGGGCCGCCCCAGCGTGGCGCGGGAGCACCCCCCGCGCCGCCAACCGAGGGCGCCGTCGAGCCGCGGGCCCCCCCCTGGCTCGCAGCGGACGGGCCAGCCAGGGCGGCCTCGGGCACCGTACTCTGCCCGGTGTGG	Cassette6_2
ACCGATATCCTGGCCTTGGGCCGCCCCAGCGTGGCGCGGGATCACCCCCCGCGCCGCCAACCGAGGGCGCCGTCGAGCCGCGGGCCCCCCCCTGGCTCGCAGCGGACGGGCCAGCCAGGGCGGCCTCGGGCACCGTACTCTGCCCGGTGTGG	Cassette6_2
ACCGATATCCTGGCCTTGGGCCGCCCCAGCGTGGCGCGGGCAGATCCCCCGCGCCGCCAACCGAGGGCGCCGTCGAGCCGCGGGCCCCCCCCTGGCTCGCAGCGGACGGGCCAGCCAGGGCGGCCTCGGGCACCGTACTCTGCCCGGTGTGG	Cassette6_3
ACCGATATCCTGGCCTTGGGCCGCCCCAGCGTGGCGCGGGCATATCCCCCGCGCCGCCAACCGAGGGCGCCGTCGAGCCGCGGGCCCCCCCCTGGCTCGCAGCGGACGGGCCAGCCAGGGCGGCCTCGGGCACCGTACTCTGCCCGGTGTGG	Cassette6_3
ACCGATATCCTGGCCTTGGGCCGCCCCAGCGTGGCGCGGGACTGTCCCCCGCGCCGCCAACCGAGGGCGCCGTCGAGCCGCGGGCCCCCCCCTGGCTCGCAGCGGACGGGCCAGCCAGGGCGGCCTCGGGCACCGTACTCTGCCCGGTGTGG	Cassette6_4
ACCGATATCCTGGCCTTGGGCCGCCCCAGCGTGGCGCGGGACTTTCCCCCGCGCCGCCAACCGAGGGCGCCGTCGAGCCGCGGGCCCCCCCCTGGCTCGCAGCGGACGGGCCAGCCAGGGCGGCCTCGGGCACCGTACTCTGCCCGGTGTGG	Cassette6_4
ACCGATATCCTGGCCTTGGGCCGCCCCAGCGTGGCGCGGGCACGGTCCCCGCGCCGCCAACCGAGGGCGCCGTCGAGCCGCGGGCCCCCCCCTGGCTCGCAGCGGACGGGCCAGCCAGGGCGGCCTCGGGCACCGTACTCTGCCCGGTGTGG	Cassette6_5
ACCGATATCCTGGCCTTGGGCCGCCCCAGCGTGGCGCGGGCACGTTCCCCGCGCCGCCAACCGAGGGCGCCGTCGAGCCGCGGGCCCCCCCCTGGCTCGCAGCGGACGGGCCAGCCAGGGCGGCCTCGGGCACCGTACTCTGCCCGGTGTGG	Cassette6_5
ACCGATATCCTGGCCTTGGGCCGCCCCAGCGTGGCGCGGGCCTACGCCCCGCGCCGCCAACCGAGGGCGCCGTCGAGCCGCGGGCCCCCCCCTGGCTCGCAGCGGACGGGCCAGCCAGGGCGGCCTCGGGCACCGTACTCTGCCCGGTGTGG	Cassette6_6
ACCGATATCCTGGCCTTGGGCCGCCCCAGCGTGGCGCGGGCCTACTCCCCGCGCCGCCAACCGAGGGCGCCGTCGAGCCGCGGGCCCCCCCCTGGCTCGCAGCGGACGGGCCAGCCAGGGCGGCCTCGGGCACCGTACTCTGCCCGGTGTGG	Cassette6_6
ACCGATATCCTGGCCTTGGGCCGCCCCAGCGTGGCGCGGGAACGTCGCCCGCGCCGCCAACCGAGGGCGCCGTCGAGCCGCGGGCCCCCCCCTGGCTCGCAGCGGACGGGCCAGCCAGGGCGGCCTCGGGCACCGTACTCTGCCCGGTGTGG	Cassette6_7
ACCGATATCCTGGCCTTGGGCCGCCCCAGCGTGGCGCGGGAACGTCTCCCGCGCCGCCAACCGAGGGCGCCGTCGAGCCGCGGGCCCCCCCCTGGCTCGCAGCGGACGGGCCAGCCAGGGCGGCCTCGGGCACCGTACTCTGCCCGGTGTGG	Cassette6_7
ACCGATATCCTGGCCTTGGGCCGCCCCAGCGTGGCGCGGGCCCATTCGCCGCGCCGCCAACCGAGGGCGCCGTCGAGCCGCGGGCCCCCCCCTGGCTCGCAGCGGACGGGCCAGCCAGGGCGGCCTCGGGCACCGTACTCTGCCCGGTGTGG	Cassette6_8
ACCGATATCCTGGCCTTGGGCCGCCCCAGCGTGGCGCGGGCCCATTCTCCGCGCCGCCAACCGAGGGCGCCGTCGAGCCGCGGGCCCCCCCCTGGCTCGCAGCGGACGGGCCAGCCAGGGCGGCCTCGGGCACCGTACTCTGCCCGGTGTGG	Cassette6_8
ACCGATATCCTGGCCTTGGGCCGCCCCAGCGTGGCGCGGGCCCGCCCCGTACGCCGCCAACCGAGGGCGCCGTCGAGCCGCGGGCCCCCCCCTGGCTCGCAGCGGACGGGCCAGCCAGGGCGGCCTCGGGCACCGTACTCTGCCCGGTGTGG	Cassette7_1
ACCGATATCCTGGCCTTGGGCCGCCCCAGCGTGGCGCGGGCCCGCCCCTTACGCCGCCAACCGAGGGCGCCGTCGAGCCGCGGGCCCCCCCCTGGCTCGCAGCGGACGGGCCAGCCAGGGCGGCCTCGGGCACCGTACTCTGCCCGGTGTGG	Cassette7_1
ACCGATATCCTGGCCTTGGGCCGCCCCAGCGTGGCGCGGGCCCGCCCCAGGAGCCGCCAACCGAGGGCGCCGTCGAGCCGCGGGCCCCCCCCTGGCTCGCAGCGGACGGGCCAGCCAGGGCGGCCTCGGGCACCGTACTCTGCCCGGTGTGG	Cassette7_2
ACCGATATCCTGGCCTTGGGCCGCCCCAGCGTGGCGCGGGCCCGCCCCATGAGCCGCCAACCGAGGGCGCCGTCGAGCCGCGGGCCCCCCCCTGGCTCGCAGCGGACGGGCCAGCCAGGGCGGCCTCGGGCACCGTACTCTGCCCGGTGTGG	Cassette7_2
ACCGATATCCTGGCCTTGGGCCGCCCCAGCGTGGCGCGGGCCCGCCCCCTGAACCGCCAACCGAGGGCGCCGTCGAGCCGCGGGCCCCCCCCTGGCTCGCAGCGGACGGGCCAGCCAGGGCGGCCTCGGGCACCGTACTCTGCCCGGTGTGG	Cassette7_3
ACCGATATCCTGGCCTTGGGCCGCCCCAGCGTGGCGCGGGCCCGCCCCCTTAACCGCCAACCGAGGGCGCCGTCGAGCCGCGGGCCCCCCCCTGGCTCGCAGCGGACGGGCCAGCCAGGGCGGCCTCGGGCACCGTACTCTGCCCGGTGTGG	Cassette7_3
ACCGATATCCTGGCCTTGGGCCGCCCCAGCGTGGCGCGGGCCCGCCCCACAGACCGCCAACCGAGGGCGCCGTCGAGCCGCGGGCCCCCCCCTGGCTCGCAGCGGACGGGCCAGCCAGGGCGGCCTCGGGCACCGTACTCTGCCCGGTGTGG	Cassette7_4
ACCGATATCCTGGCCTTGGGCCGCCCCAGCGTGGCGCGGGCCCGCCCCACATACCGCCAACCGAGGGCGCCGTCGAGCCGCGGGCCCCCCCCTGGCTCGCAGCGGACGGGCCAGCCAGGGCGGCCTCGGGCACCGTACTCTGCCCGGTGTGG	Cassette7_4
ACCGATATCCTGGCCTTGGGCCGCCCCAGCGTGGCGCGGGCCCGCCCCCTGCGTCGCCAACCGAGGGCGCCGTCGAGCCGCGGGCCCCCCCCTGGCTCGCAGCGGACGGGCCAGCCAGGGCGGCCTCGGGCACCGTACTCTGCCCGGTGTGG	Cassette7_5
ACCGATATCCTGGCCTTGGGCCGCCCCAGCGTGGCGCGGGCCCGCCCCCTGCTTCGCCAACCGAGGGCGCCGTCGAGCCGCGGGCCCCCCCCTGGCTCGCAGCGGACGGGCCAGCCAGGGCGGCCTCGGGCACCGTACTCTGCCCGGTGTGG	Cassette7_5
ACCGATATCCTGGCCTTGGGCCGCCCCAGCGTGGCGCGGGCCCGCCCCCCAAGGCGCCAACCGAGGGCGCCGTCGAGCCGCGGGCCCCCCCCTGGCTCGCAGCGGACGGGCCAGCCAGGGCGGCCTCGGGCACCGTACTCTGCCCGGTGTGG	Cassette7_6
ACCGATATCCTGGCCTTGGGCCGCCCCAGCGTGGCGCGGGCCCGCCCCCCAAGTCGCCAACCGAGGGCGCCGTCGAGCCGCGGGCCCCCCCCTGGCTCGCAGCGGACGGGCCAGCCAGGGCGGCCTCGGGCACCGTACTCTGCCCGGTGTGG	Cassette7_6
ACCGATATCCTGGCCTTGGGCCGCCCCAGCGTGGCGCGGGCCCGCCCCATGCACGGCCAACCGAGGGCGCCGTCGAGCCGCGGGCCCCCCCCTGGCTCGCAGCGGACGGGCCAGCCAGGGCGGCCTCGGGCACCGTACTCTGCCCGGTGTGG	Cassette7_7
ACCGATATCCTGGCCTTGGGCCGCCCCAGCGTGGCGCGGGCCCGCCCCATGCACTGCCAACCGAGGGCGCCGTCGAGCCGCGGGCCCCCCCCTGGCTCGCAGCGGACGGGCCAGCCAGGGCGGCCTCGGGCACCGTACTCTGCCCGGTGTGG	Cassette7_7
ACCGATATCCTGGCCTTGGGCCGCCCCAGCGTGGCGCGGGCCCGCCCCCCGAATCGCCAACCGAGGGCGCCGTCGAGCCGCGGGCCCCCCCCTGGCTCGCAGCGGACGGGCCAGCCAGGGCGGCCTCGGGCACCGTACTCTGCCCGGTGTGG	Cassette7_8
ACCGATATCCTGGCCTTGGGCCGCCCCAGCGTGGCGCGGGCCCGCCCCCCGAATCTCCAACCGAGGGCGCCGTCGAGCCGCGGGCCCCCCCCTGGCTCGCAGCGGACGGGCCAGCCAGGGCGGCCTCGGGCACCGTACTCTGCCCGGTGTGG	Cassette7_8
ACCGATATCCTGGCCTTGGGCCGCCCCAGCGTGGCGCGGGCCCGCCCCCCGCGCCGGTCACCGAGGGCGCCGTCGAGCCGCGGGCCCCCCCCTGGCTCGCAGCGGACGGGCCAGCCAGGGCGGCCTCGGGCACCGTACTCTGCCCGGTGTGG	Cassette8_1
ACCGATATCCTGGCCTTGGGCCGCCCCAGCGTGGCGCGGGCCCGCCCCCCGCGCCGTTCACCGAGGGCGCCGTCGAGCCGCGGGCCCCCCCCTGGCTCGCAGCGGACGGGCCAGCCAGGGCGGCCTCGGGCACCGTACTCTGCCCGGTGTGG	Cassette8_1
ACCGATATCCTGGCCTTGGGCCGCCCCAGCGTGGCGCGGGCCCGCCCCCCGCGCCGTGACCCGAGGGCGCCGTCGAGCCGCGGGCCCCCCCCTGGCTCGCAGCGGACGGGCCAGCCAGGGCGGCCTCGGGCACCGTACTCTGCCCGGTGTGG	Cassette8_2
ACCGATATCCTGGCCTTGGGCCGCCCCAGCGTGGCGCGGGCCCGCCCCCCGCGCCGTTACCCGAGGGCGCCGTCGAGCCGCGGGCCCCCCCCTGGCTCGCAGCGGACGGGCCAGCCAGGGCGGCCTCGGGCACCGTACTCTGCCCGGTGTGG	Cassette8_2
ACCGATATCCTGGCCTTGGGCCGCCCCAGCGTGGCGCGGGCCCGCCCCCCGCGCCGCCGCTCGAGGGCGCCGTCGAGCCGCGGGCCCCCCCCTGGCTCGCAGCGGACGGGCCAGCCAGGGCGGCCTCGGGCACCGTACTCTGCCCGGTGTGG	Cassette8_3
ACCGATATCCTGGCCTTGGGCCGCCCCAGCGTGGCGCGGGCCCGCCCCCCGCGCCGCCTCTCGAGGGCGCCGTCGAGCCGCGGGCCCCCCCCTGGCTCGCAGCGGACGGGCCAGCCAGGGCGGCCTCGGGCACCGTACTCTGCCCGGTGTGG	Cassette8_3
ACCGATATCCTGGCCTTGGGCCGCCCCAGCGTGGCGCGGGCCCGCCCCCCGCGCCGCCCGCAGAGGGCGCCGTCGAGCCGCGGGCCCCCCCCTGGCTCGCAGCGGACGGGCCAGCCAGGGCGGCCTCGGGCACCGTACTCTGCCCGGTGTGG	Cassette8_4
ACCGATATCCTGGCCTTGGGCCGCCCCAGCGTGGCGCGGGCCCGCCCCCCGCGCCGCCCTCAGAGGGCGCCGTCGAGCCGCGGGCCCCCCCCTGGCTCGCAGCGGACGGGCCAGCCAGGGCGGCCTCGGGCACCGTACTCTGCCCGGTGTGG	Cassette8_4
ACCGATATCCTGGCCTTGGGCCGCCCCAGCGTGGCGCGGGCCCGCCCCCCGCGCCGCTAAGAGAGGGCGCCGTCGAGCCGCGGGCCCCCCCCTGGCTCGCAGCGGACGGGCCAGCCAGGGCGGCCTCGGGCACCGTACTCTGCCCGGTGTGG	Cassette8_5
ACCGATATCCTGGCCTTGGGCCGCCCCAGCGTGGCGCGGGCCCGCCCCCCGCGCCGCTAATAGAGGGCGCCGTCGAGCCGCGGGCCCCCCCCTGGCTCGCAGCGGACGGGCCAGCCAGGGCGGCCTCGGGCACCGTACTCTGCCCGGTGTGG	Cassette8_5
ACCGATATCCTGGCCTTGGGCCGCCCCAGCGTGGCGCGGGCCCGCCCCCCGCGCCGTCCATGGAGGGCGCCGTCGAGCCGCGGGCCCCCCCCTGGCTCGCAGCGGACGGGCCAGCCAGGGCGGCCTCGGGCACCGTACTCTGCCCGGTGTGG	Cassette8_6
ACCGATATCCTGGCCTTGGGCCGCCCCAGCGTGGCGCGGGCCCGCCCCCCGCGCCGTCCATTGAGGGCGCCGTCGAGCCGCGGGCCCCCCCCTGGCTCGCAGCGGACGGGCCAGCCAGGGCGGCCTCGGGCACCGTACTCTGCCCGGTGTGG	Cassette8_6
ACCGATATCCTGGCCTTGGGCCGCCCCAGCGTGGCGCGGGCCCGCCCCCCGCGCCGTTCCTCGAGGGCGCCGTCGAGCCGCGGGCCCCCCCCTGGCTCGCAGCGGACGGGCCAGCCAGGGCGGCCTCGGGCACCGTACTCTGCCCGGTGTGG	Cassette8_7
ACCGATATCCTGGCCTTGGGCCGCCCCAGCGTGGCGCGGGCCCGCCCCCCGCGCCGTTCCTCTAGGGCGCCGTCGAGCCGCGGGCCCCCCCCTGGCTCGCAGCGGACGGGCCAGCCAGGGCGGCCTCGGGCACCGTACTCTGCCCGGTGTGG	Cassette8_7
ACCGATATCCTGGCCTTGGGCCGCCCCAGCGTGGCGCGGGCCCGCCCCCCGCGCCGTTAATCGGGGGCGCCGTCGAGCCGCGGGCCCCCCCCTGGCTCGCAGCGGACGGGCCAGCCAGGGCGGCCTCGGGCACCGTACTCTGCCCGGTGTGG	Cassette8_8
ACCGATATCCTGGCCTTGGGCCGCCCCAGCGTGGCGCGGGCCCGCCCCCCGCGCCGTTAATCGTGGGCGCCGTCGAGCCGCGGGCCCCCCCCTGGCTCGCAGCGGACGGGCCAGCCAGGGCGGCCTCGGGCACCGTACTCTGCCCGGTGTGG	Cassette8_8
ACCGATATCCTGGCCTTGGGCCGCCCCAGCGTGGCGCGGGCCCGCCCCCCGCGCCGCCAACCGAGCACGCCGTCGAGCCGCGGGCCCCCCCCTGGCTCGCAGCGGACGGGCCAGCCAGGGCGGCCTCGGGCACCGTACTCTGCCCGGTGTGG	Cassette9_1
ACCGATATCCTGGCCTTGGGCCGCCCCAGCGTGGCGCGGGCCCGCCCCCCGCGCCGCCAACCGATCACGCCGTCGAGCCGCGGGCCCCCCCCTGGCTCGCAGCGGACGGGCCAGCCAGGGCGGCCTCGGGCACCGTACTCTGCCCGGTGTGG	Cassette9_1
ACCGATATCCTGGCCTTGGGCCGCCCCAGCGTGGCGCGGGCCCGCCCCCCGCGCCGCCAACCGAAGGTGCCGTCGAGCCGCGGGCCCCCCCCTGGCTCGCAGCGGACGGGCCAGCCAGGGCGGCCTCGGGCACCGTACTCTGCCCGGTGTGG	Cassette9_2
ACCGATATCCTGGCCTTGGGCCGCCCCAGCGTGGCGCGGGCCCGCCCCCCGCGCCGCCAACCGAATGTGCCGTCGAGCCGCGGGCCCCCCCCTGGCTCGCAGCGGACGGGCCAGCCAGGGCGGCCTCGGGCACCGTACTCTGCCCGGTGTGG	Cassette9_2
ACCGATATCCTGGCCTTGGGCCGCCCCAGCGTGGCGCGGGCCCGCCCCCCGCGCCGCCAACCGAGCGTACCGTCGAGCCGCGGGCCCCCCCCTGGCTCGCAGCGGACGGGCCAGCCAGGGCGGCCTCGGGCACCGTACTCTGCCCGGTGTGG	Cassette9_3
ACCGATATCCTGGCCTTGGGCCGCCCCAGCGTGGCGCGGGCCCGCCCCCCGCGCCGCCAACCGAGCTTACCGTCGAGCCGCGGGCCCCCCCCTGGCTCGCAGCGGACGGGCCAGCCAGGGCGGCCTCGGGCACCGTACTCTGCCCGGTGTGG	Cassette9_3
ACCGATATCCTGGCCTTGGGCCGCCCCAGCGTGGCGCGGGCCCGCCCCCCGCGCCGCCAACCGAAGAGACCGTCGAGCCGCGGGCCCCCCCCTGGCTCGCAGCGGACGGGCCAGCCAGGGCGGCCTCGGGCACCGTACTCTGCCCGGTGTGG	Cassette9_4
ACCGATATCCTGGCCTTGGGCCGCCCCAGCGTGGCGCGGGCCCGCCCCCCGCGCCGCCAACCGAAGATACCGTCGAGCCGCGGGCCCCCCCCTGGCTCGCAGCGGACGGGCCAGCCAGGGCGGCCTCGGGCACCGTACTCTGCCCGGTGTGG	Cassette9_4
ACCGATATCCTGGCCTTGGGCCGCCCCAGCGTGGCGCGGGCCCGCCCCCCGCGCCGCCAACCGAGCGCGACGTCGAGCCGCGGGCCCCCCCCTGGCTCGCAGCGGACGGGCCAGCCAGGGCGGCCTCGGGCACCGTACTCTGCCCGGTGTGG	Cassette9_5
ACCGATATCCTGGCCTTGGGCCGCCCCAGCGTGGCGCGGGCCCGCCCCCCGCGCCGCCAACCGAGCGCTACGTCGAGCCGCGGGCCCCCCCCTGGCTCGCAGCGGACGGGCCAGCCAGGGCGGCCTCGGGCACCGTACTCTGCCCGGTGTGG	Cassette9_5
ACCGATATCCTGGCCTTGGGCCGCCCCAGCGTGGCGCGGGCCCGCCCCCCGCGCCGCCAACCGAGGATGGCGTCGAGCCGCGGGCCCCCCCCTGGCTCGCAGCGGACGGGCCAGCCAGGGCGGCCTCGGGCACCGTACTCTGCCCGGTGTGG	Cassette9_6
ACCGATATCCTGGCCTTGGGCCGCCCCAGCGTGGCGCGGGCCCGCCCCCCGCGCCGCCAACCGAGGATGTCGTCGAGCCGCGGGCCCCCCCCTGGCTCGCAGCGGACGGGCCAGCCAGGGCGGCCTCGGGCACCGTACTCTGCCCGGTGTGG	Cassette9_6
ACCGATATCCTGGCCTTGGGCCGCCCCAGCGTGGCGCGGGCCCGCCCCCCGCGCCGCCAACCGAACGCACGGTCGAGCCGCGGGCCCCCCCCTGGCTCGCAGCGGACGGGCCAGCCAGGGCGGCCTCGGGCACCGTACTCTGCCCGGTGTGG	Cassette9_7
ACCGATATCCTGGCCTTGGGCCGCCCCAGCGTGGCGCGGGCCCGCCCCCCGCGCCGCCAACCGAACGCACTGTCGAGCCGCGGGCCCCCCCCTGGCTCGCAGCGGACGGGCCAGCCAGGGCGGCCTCGGGCACCGTACTCTGCCCGGTGTGG	Cassette9_7
ACCGATATCCTGGCCTTGGGCCGCCCCAGCGTGGCGCGGGCCCGCCCCCCGCGCCGCCAACCGAGGACAACGTCGAGCCGCGGGCCCCCCCCTGGCTCGCAGCGGACGGGCCAGCCAGGGCGGCCTCGGGCACCGTACTCTGCCCGGTGTGG	Cassette9_8
ACCGATATCCTGGCCTTGGGCCGCCCCAGCGTGGCGCGGGCCCGCCCCCCGCGCCGCCAACCGAGGACAACTTCGAGCCGCGGGCCCCCCCCTGGCTCGCAGCGGACGGGCCAGCCAGGGCGGCCTCGGGCACCGTACTCTGCCCGGTGTGG	Cassette9_8
ACCGATATCCTGGCCTTGGGCCGCCCCAGCGTGGCGCGGGCCCGCCCCCCGCGCCGCCAACCGAGGGCGCCGGAAAGCCGCGGGCCCCCCCCTGGCTCGCAGCGGACGGGCCAGCCAGGGCGGCCTCGGGCACCGTACTCTGCCCGGTGTGG	Cassette10_1
ACCGATATCCTGGCCTTGGGCCGCCCCAGCGTGGCGCGGGCCCGCCCCCCGCGCCGCCAACCGAGGGCGCCGTAAAGCCGCGGGCCCCCCCCTGGCTCGCAGCGGACGGGCCAGCCAGGGCGGCCTCGGGCACCGTACTCTGCCCGGTGTGG	Cassette10_1
ACCGATATCCTGGCCTTGGGCCGCCCCAGCGTGGCGCGGGCCCGCCCCCCGCGCCGCCAACCGAGGGCGCCGCGGCGCCGCGGGCCCCCCCCTGGCTCGCAGCGGACGGGCCAGCCAGGGCGGCCTCGGGCACCGTACTCTGCCCGGTGTGG	Cassette10_2
ACCGATATCCTGGCCTTGGGCCGCCCCAGCGTGGCGCGGGCCCGCCCCCCGCGCCGCCAACCGAGGGCGCCGCTGCGCCGCGGGCCCCCCCCTGGCTCGCAGCGGACGGGCCAGCCAGGGCGGCCTCGGGCACCGTACTCTGCCCGGTGTGG	Cassette10_2
ACCGATATCCTGGCCTTGGGCCGCCCCAGCGTGGCGCGGGCCCGCCCCCCGCGCCGCCAACCGAGGGCGCCGCCGACCCGCGGGCCCCCCCCTGGCTCGCAGCGGACGGGCCAGCCAGGGCGGCCTCGGGCACCGTACTCTGCCCGGTGTGG	Cassette10_3
ACCGATATCCTGGCCTTGGGCCGCCCCAGCGTGGCGCGGGCCCGCCCCCCGCGCCGCCAACCGAGGGCGCCGCCTACCCGCGGGCCCCCCCCTGGCTCGCAGCGGACGGGCCAGCCAGGGCGGCCTCGGGCACCGTACTCTGCCCGGTGTGG	Cassette10_3
ACCGATATCCTGGCCTTGGGCCGCCCCAGCGTGGCGCGGGCCCGCCCCCCGCGCCGCCAACCGAGGGCGCCGTAGGCCCGCGGGCCCCCCCCTGGCTCGCAGCGGACGGGCCAGCCAGGGCGGCCTCGGGCACCGTACTCTGCCCGGTGTGG	Cassette10_4
ACCGATATCCTGGCCTTGGGCCGCCCCAGCGTGGCGCGGGCCCGCCCCCCGCGCCGCCAACCGAGGGCGCCGTAGTCCCGCGGGCCCCCCCCTGGCTCGCAGCGGACGGGCCAGCCAGGGCGGCCTCGGGCACCGTACTCTGCCCGGTGTGG	Cassette10_4
ACCGATATCCTGGCCTTGGGCCGCCCCAGCGTGGCGCGGGCCCGCCCCCCGCGCCGCCAACCGAGGGCGCCGTCACGCCGCGGGCCCCCCCCTGGCTCGCAGCGGACGGGCCAGCCAGGGCGGCCTCGGGCACCGTACTCTGCCCGGTGTGG	Cassette10_5
ACCGATATCCTGGCCTTGGGCCGCCCCAGCGTGGCGCGGGCCCGCCCCCCGCGCCGCCAACCGAGGGCGCCGTCACTCCGCGGGCCCCCCCCTGGCTCGCAGCGGACGGGCCAGCCAGGGCGGCCTCGGGCACCGTACTCTGCCCGGTGTGG	Cassette10_5
ACCGATATCCTGGCCTTGGGCCGCCCCAGCGTGGCGCGGGCCCGCCCCCCGCGCCGCCAACCGAGGGCGCCGCAACCGCGCGGGCCCCCCCCTGGCTCGCAGCGGACGGGCCAGCCAGGGCGGCCTCGGGCACCGTACTCTGCCCGGTGTGG	Cassette10_6
ACCGATATCCTGGCCTTGGGCCGCCCCAGCGTGGCGCGGGCCCGCCCCCCGCGCCGCCAACCGAGGGCGCCGCAACCTCGCGGGCCCCCCCCTGGCTCGCAGCGGACGGGCCAGCCAGGGCGGCCTCGGGCACCGTACTCTGCCCGGTGTGG	Cassette10_6
ACCGATATCCTGGCCTTGGGCCGCCCCAGCGTGGCGCGGGCCCGCCCCCCGCGCCGCCAACCGAGGGCGCCGCAGACTGGCGGGCCCCCCCCTGGCTCGCAGCGGACGGGCCAGCCAGGGCGGCCTCGGGCACCGTACTCTGCCCGGTGTGG	Cassette10_7
ACCGATATCCTGGCCTTGGGCCGCCCCAGCGTGGCGCGGGCCCGCCCCCCGCGCCGCCAACCGAGGGCGCCGCAGACTTGCGGGCCCCCCCCTGGCTCGCAGCGGACGGGCCAGCCAGGGCGGCCTCGGGCACCGTACTCTGCCCGGTGTGG	Cassette10_7
ACCGATATCCTGGCCTTGGGCCGCCCCAGCGTGGCGCGGGCCCGCCCCCCGCGCCGCCAACCGAGGGCGCCGCCAAGTCGCGGGCCCCCCCCTGGCTCGCAGCGGACGGGCCAGCCAGGGCGGCCTCGGGCACCGTACTCTGCCCGGTGTGG	Cassette10_8
ACCGATATCCTGGCCTTGGGCCGCCCCAGCGTGGCGCGGGCCCGCCCCCCGCGCCGCCAACCGAGGGCGCCGCCAAGTCTCGGGCCCCCCCCTGGCTCGCAGCGGACGGGCCAGCCAGGGCGGCCTCGGGCACCGTACTCTGCCCGGTGTGG	Cassette10_8
ACCGATATCCTGGCCTTGGGCCGCCCCAGCGTGGCGCGGGCCCGCCCCCCGCGCCGCCAACCGAGGGCGCCGTCGAGCCGGAAGCCCCCCCCTGGCTCGCAGCGGACGGGCCAGCCAGGGCGGCCTCGGGCACCGTACTCTGCCCGGTGTGG	Cassette11_1
ACCGATATCCTGGCCTTGGGCCGCCCCAGCGTGGCGCGGGCCCGCCCCCCGCGCCGCCAACCGAGGGCGCCGTCGAGCCGTAAGCCCCCCCCTGGCTCGCAGCGGACGGGCCAGCCAGGGCGGCCTCGGGCACCGTACTCTGCCCGGTGTGG	Cassette11_1
ACCGATATCCTGGCCTTGGGCCGCCCCAGCGTGGCGCGGGCCCGCCCCCCGCGCCGCCAACCGAGGGCGCCGTCGAGCCGAGGCCCCCCCCCTGGCTCGCAGCGGACGGGCCAGCCAGGGCGGCCTCGGGCACCGTACTCTGCCCGGTGTGG	Cassette11_2
ACCGATATCCTGGCCTTGGGCCGCCCCAGCGTGGCGCGGGCCCGCCCCCCGCGCCGCCAACCGAGGGCGCCGTCGAGCCGATGCCCCCCCCCTGGCTCGCAGCGGACGGGCCAGCCAGGGCGGCCTCGGGCACCGTACTCTGCCCGGTGTGG	Cassette11_2
ACCGATATCCTGGCCTTGGGCCGCCCCAGCGTGGCGCGGGCCCGCCCCCCGCGCCGCCAACCGAGGGCGCCGTCGAGCCGAGGGTCCCCCCCTGGCTCGCAGCGGACGGGCCAGCCAGGGCGGCCTCGGGCACCGTACTCTGCCCGGTGTGG	Cassette11_3
ACCGATATCCTGGCCTTGGGCCGCCCCAGCGTGGCGCGGGCCCGCCCCCCGCGCCGCCAACCGAGGGCGCCGTCGAGCCGAGTGTCCCCCCCTGGCTCGCAGCGGACGGGCCAGCCAGGGCGGCCTCGGGCACCGTACTCTGCCCGGTGTGG	Cassette11_3
ACCGATATCCTGGCCTTGGGCCGCCCCAGCGTGGCGCGGGCCCGCCCCCCGCGCCGCCAACCGAGGGCGCCGTCGAGCCGCAGGTCCCCCCCTGGCTCGCAGCGGACGGGCCAGCCAGGGCGGCCTCGGGCACCGTACTCTGCCCGGTGTGG	Cassette11_4
ACCGATATCCTGGCCTTGGGCCGCCCCAGCGTGGCGCGGGCCCGCCCCCCGCGCCGCCAACCGAGGGCGCCGTCGAGCCGCAGTTCCCCCCCTGGCTCGCAGCGGACGGGCCAGCCAGGGCGGCCTCGGGCACCGTACTCTGCCCGGTGTGG	Cassette11_4
ACCGATATCCTGGCCTTGGGCCGCCCCAGCGTGGCGCGGGCCCGCCCCCCGCGCCGCCAACCGAGGGCGCCGTCGAGCCGCGACGCCCCCCCTGGCTCGCAGCGGACGGGCCAGCCAGGGCGGCCTCGGGCACCGTACTCTGCCCGGTGTGG	Cassette11_5
ACCGATATCCTGGCCTTGGGCCGCCCCAGCGTGGCGCGGGCCCGCCCCCCGCGCCGCCAACCGAGGGCGCCGTCGAGCCGCGACTCCCCCCCTGGCTCGCAGCGGACGGGCCAGCCAGGGCGGCCTCGGGCACCGTACTCTGCCCGGTGTGG	Cassette11_5
ACCGATATCCTGGCCTTGGGCCGCCCCAGCGTGGCGCGGGCCCGCCCCCCGCGCCGCCAACCGAGGGCGCCGTCGAGCCGAAACTGCCCCCCTGGCTCGCAGCGGACGGGCCAGCCAGGGCGGCCTCGGGCACCGTACTCTGCCCGGTGTGG	Cassette11_6
ACCGATATCCTGGCCTTGGGCCGCCCCAGCGTGGCGCGGGCCCGCCCCCCGCGCCGCCAACCGAGGGCGCCGTCGAGCCGAAACTTCCCCCCTGGCTCGCAGCGGACGGGCCAGCCAGGGCGGCCTCGGGCACCGTACTCTGCCCGGTGTGG	Cassette11_6
ACCGATATCCTGGCCTTGGGCCGCCCCAGCGTGGCGCGGGCCCGCCCCCCGCGCCGCCAACCGAGGGCGCCGTCGAGCCGAGACCTGCCCCCTGGCTCGCAGCGGACGGGCCAGCCAGGGCGGCCTCGGGCACCGTACTCTGCCCGGTGTGG	Cassette11_7
ACCGATATCCTGGCCTTGGGCCGCCCCAGCGTGGCGCGGGCCCGCCCCCCGCGCCGCCAACCGAGGGCGCCGTCGAGCCGAGACCTTCCCCCTGGCTCGCAGCGGACGGGCCAGCCAGGGCGGCCTCGGGCACCGTACTCTGCCCGGTGTGG	Cassette11_7
ACCGATATCCTGGCCTTGGGCCGCCCCAGCGTGGCGCGGGCCCGCCCCCCGCGCCGCCAACCGAGGGCGCCGTCGAGCCGAGGCTTCGCCCCTGGCTCGCAGCGGACGGGCCAGCCAGGGCGGCCTCGGGCACCGTACTCTGCCCGGTGTGG	Cassette11_8
ACCGATATCCTGGCCTTGGGCCGCCCCAGCGTGGCGCGGGCCCGCCCCCCGCGCCGCCAACCGAGGGCGCCGTCGAGCCGAGGCTTCTCCCCTGGCTCGCAGCGGACGGGCCAGCCAGGGCGGCCTCGGGCACCGTACTCTGCCCGGTGTGG	Cassette11_8
ACCGATATCCTGGCCTTGGGCCGCCCCAGCGTGGCGCGGGCCCGCCCCCCGCGCCGCCAACCGAGGGCGCCGTCGAGCCGCGGGCCCCGAACTGGCTCGCAGCGGACGGGCCAGCCAGGGCGGCCTCGGGCACCGTACTCTGCCCGGTGTGG	Cassette12_1
ACCGATATCCTGGCCTTGGGCCGCCCCAGCGTGGCGCGGGCCCGCCCCCCGCGCCGCCAACCGAGGGCGCCGTCGAGCCGCGGGCCCCTAACTGGCTCGCAGCGGACGGGCCAGCCAGGGCGGCCTCGGGCACCGTACTCTGCCCGGTGTGG	Cassette12_1
ACCGATATCCTGGCCTTGGGCCGCCCCAGCGTGGCGCGGGCCCGCCCCCCGCGCCGCCAACCGAGGGCGCCGTCGAGCCGCGGGCCCCTGCTTGGCTCGCAGCGGACGGGCCAGCCAGGGCGGCCTCGGGCACCGTACTCTGCCCGGTGTGG	Cassette12_2
ACCGATATCCTGGCCTTGGGCCGCCCCAGCGTGGCGCGGGCCCGCCCCCCGCGCCGCCAACCGAGGGCGCCGTCGAGCCGCGGGCCCCTTCTTGGCTCGCAGCGGACGGGCCAGCCAGGGCGGCCTCGGGCACCGTACTCTGCCCGGTGTGG	Cassette12_2
ACCGATATCCTGGCCTTGGGCCGCCCCAGCGTGGCGCGGGCCCGCCCCCCGCGCCGCCAACCGAGGGCGCCGTCGAGCCGCGGGCCCCTCGCGGGCTCGCAGCGGACGGGCCAGCCAGGGCGGCCTCGGGCACCGTACTCTGCCCGGTGTGG	Cassette12_3
ACCGATATCCTGGCCTTGGGCCGCCCCAGCGTGGCGCGGGCCCGCCCCCCGCGCCGCCAACCGAGGGCGCCGTCGAGCCGCGGGCCCCTCTCGGGCTCGCAGCGGACGGGCCAGCCAGGGCGGCCTCGGGCACCGTACTCTGCCCGGTGTGG	Cassette12_3
ACCGATATCCTGGCCTTGGGCCGCCCCAGCGTGGCGCGGGCCCGCCCCCCGCGCCGCCAACCGAGGGCGCCGTCGAGCCGCGGGCCCCCACGGGGCTCGCAGCGGACGGGCCAGCCAGGGCGGCCTCGGGCACCGTACTCTGCCCGGTGTGG	Cassette12_4
ACCGATATCCTGGCCTTGGGCCGCCCCAGCGTGGCGCGGGCCCGCCCCCCGCGCCGCCAACCGAGGGCGCCGTCGAGCCGCGGGCCCCCACTGGGCTCGCAGCGGACGGGCCAGCCAGGGCGGCCTCGGGCACCGTACTCTGCCCGGTGTGG	Cassette12_4
ACCGATATCCTGGCCTTGGGCCGCCCCAGCGTGGCGCGGGCCCGCCCCCCGCGCCGCCAACCGAGGGCGCCGTCGAGCCGCGGGCCCCCCATGGGCTCGCAGCGGACGGGCCAGCCAGGGCGGCCTCGGGCACCGTACTCTGCCCGGTGTGG	Cassette12_5
ACCGATATCCTGGCCTTGGGCCGCCCCAGCGTGGCGCGGGCCCGCCCCCCGCGCCGCCAACCGAGGGCGCCGTCGAGCCGCGGGCCCCCCATTGGCTCGCAGCGGACGGGCCAGCCAGGGCGGCCTCGGGCACCGTACTCTGCCCGGTGTGG	Cassette12_5
ACCGATATCCTGGCCTTGGGCCGCCCCAGCGTGGCGCGGGCCCGCCCCCCGCGCCGCCAACCGAGGGCGCCGTCGAGCCGCGGGCCCCTAATGGGCTCGCAGCGGACGGGCCAGCCAGGGCGGCCTCGGGCACCGTACTCTGCCCGGTGTGG	Cassette12_6
ACCGATATCCTGGCCTTGGGCCGCCCCAGCGTGGCGCGGGCCCGCCCCCCGCGCCGCCAACCGAGGGCGCCGTCGAGCCGCGGGCCCCTAATGTGCTCGCAGCGGACGGGCCAGCCAGGGCGGCCTCGGGCACCGTACTCTGCCCGGTGTGG	Cassette12_6
ACCGATATCCTGGCCTTGGGCCGCCCCAGCGTGGCGCGGGCCCGCCCCCCGCGCCGCCAACCGAGGGCGCCGTCGAGCCGCGGGCCCCTACCTAGCTCGCAGCGGACGGGCCAGCCAGGGCGGCCTCGGGCACCGTACTCTGCCCGGTGTGG	Cassette12_7
ACCGATATCCTGGCCTTGGGCCGCCCCAGCGTGGCGCGGGCCCGCCCCCCGCGCCGCCAACCGAGGGCGCCGTCGAGCCGCGGGCCCCTACCTATCTCGCAGCGGACGGGCCAGCCAGGGCGGCCTCGGGCACCGTACTCTGCCCGGTGTGG	Cassette12_7
ACCGATATCCTGGCCTTGGGCCGCCCCAGCGTGGCGCGGGCCCGCCCCCCGCGCCGCCAACCGAGGGCGCCGTCGAGCCGCGGGCCCCTCCTGAGGTCGCAGCGGACGGGCCAGCCAGGGCGGCCTCGGGCACCGTACTCTGCCCGGTGTGG	Cassette12_8
ACCGATATCCTGGCCTTGGGCCGCCCCAGCGTGGCGCGGGCCCGCCCCCCGCGCCGCCAACCGAGGGCGCCGTCGAGCCGCGGGCCCCTCCTGAGTTCGCAGCGGACGGGCCAGCCAGGGCGGCCTCGGGCACCGTACTCTGCCCGGTGTGG	Cassette12_8
ACCGATATCCTGGCCTTGGGCCGCCCCAGCGTGGCGCGGGCCCGCCCCCCGCGCCGCCAACCGAGGGCGCCGTCGAGCCGCGGGCCCCCCCCTGGCGACCAGCGGACGGGCCAGCCAGGGCGGCCTCGGGCACCGTACTCTGCCCGGTGTGG	Cassette13_1
ACCGATATCCTGGCCTTGGGCCGCCCCAGCGTGGCGCGGGCCCGCCCCCCGCGCCGCCAACCGAGGGCGCCGTCGAGCCGCGGGCCCCCCCCTGGCTACCAGCGGACGGGCCAGCCAGGGCGGCCTCGGGCACCGTACTCTGCCCGGTGTGG	Cassette13_1
ACCGATATCCTGGCCTTGGGCCGCCCCAGCGTGGCGCGGGCCCGCCCCCCGCGCCGCCAACCGAGGGCGCCGTCGAGCCGCGGGCCCCCCCCTGGCCGGTAGCGGACGGGCCAGCCAGGGCGGCCTCGGGCACCGTACTCTGCCCGGTGTGG	Cassette13_2
ACCGATATCCTGGCCTTGGGCCGCCCCAGCGTGGCGCGGGCCCGCCCCCCGCGCCGCCAACCGAGGGCGCCGTCGAGCCGCGGGCCCCCCCCTGGCCTGTAGCGGACGGGCCAGCCAGGGCGGCCTCGGGCACCGTACTCTGCCCGGTGTGG	Cassette13_2
ACCGATATCCTGGCCTTGGGCCGCCCCAGCGTGGCGCGGGCCCGCCCCCCGCGCCGCCAACCGAGGGCGCCGTCGAGCCGCGGGCCCCCCCCTGGCTCGTGGCGGACGGGCCAGCCAGGGCGGCCTCGGGCACCGTACTCTGCCCGGTGTGG	Cassette13_3
ACCGATATCCTGGCCTTGGGCCGCCCCAGCGTGGCGCGGGCCCGCCCCCCGCGCCGCCAACCGAGGGCGCCGTCGAGCCGCGGGCCCCCCCCTGGCTCTTGGCGGACGGGCCAGCCAGGGCGGCCTCGGGCACCGTACTCTGCCCGGTGTGG	Cassette13_3
ACCGATATCCTGGCCTTGGGCCGCCCCAGCGTGGCGCGGGCCCGCCCCCCGCGCCGCCAACCGAGGGCGCCGTCGAGCCGCGGGCCCCCCCCTGGCTCCGACCGGACGGGCCAGCCAGGGCGGCCTCGGGCACCGTACTCTGCCCGGTGTGG	Cassette13_4
ACCGATATCCTGGCCTTGGGCCGCCCCAGCGTGGCGCGGGCCCGCCCCCCGCGCCGCCAACCGAGGGCGCCGTCGAGCCGCGGGCCCCCCCCTGGCTCCTACCGGACGGGCCAGCCAGGGCGGCCTCGGGCACCGTACTCTGCCCGGTGTGG	Cassette13_4
ACCGATATCCTGGCCTTGGGCCGCCCCAGCGTGGCGCGGGCCCGCCCCCCGCGCCGCCAACCGAGGGCGCCGTCGAGCCGCGGGCCCCCCCCTGGCTAGCGCCGGACGGGCCAGCCAGGGCGGCCTCGGGCACCGTACTCTGCCCGGTGTGG	Cassette13_5
ACCGATATCCTGGCCTTGGGCCGCCCCAGCGTGGCGCGGGCCCGCCCCCCGCGCCGCCAACCGAGGGCGCCGTCGAGCCGCGGGCCCCCCCCTGGCTAGCTCCGGACGGGCCAGCCAGGGCGGCCTCGGGCACCGTACTCTGCCCGGTGTGG	Cassette13_5
ACCGATATCCTGGCCTTGGGCCGCCCCAGCGTGGCGCGGGCCCGCCCCCCGCGCCGCCAACCGAGGGCGCCGTCGAGCCGCGGGCCCCCCCCTGGCCCCCGGCGGACGGGCCAGCCAGGGCGGCCTCGGGCACCGTACTCTGCCCGGTGTGG	Cassette13_6
ACCGATATCCTGGCCTTGGGCCGCCCCAGCGTGGCGCGGGCCCGCCCCCCGCGCCGCCAACCGAGGGCGCCGTCGAGCCGCGGGCCCCCCCCTGGCCCCCGTCGGACGGGCCAGCCAGGGCGGCCTCGGGCACCGTACTCTGCCCGGTGTGG	Cassette13_6
ACCGATATCCTGGCCTTGGGCCGCCCCAGCGTGGCGCGGGCCCGCCCCCCGCGCCGCCAACCGAGGGCGCCGTCGAGCCGCGGGCCCCCCCCTGGCCACTGGGGGACGGGCCAGCCAGGGCGGCCTCGGGCACCGTACTCTGCCCGGTGTGG	Cassette13_7
ACCGATATCCTGGCCTTGGGCCGCCCCAGCGTGGCGCGGGCCCGCCCCCCGCGCCGCCAACCGAGGGCGCCGTCGAGCCGCGGGCCCCCCCCTGGCCACTGGTGGACGGGCCAGCCAGGGCGGCCTCGGGCACCGTACTCTGCCCGGTGTGG	Cassette13_7
ACCGATATCCTGGCCTTGGGCCGCCCCAGCGTGGCGCGGGCCCGCCCCCCGCGCCGCCAACCGAGGGCGCCGTCGAGCCGCGGGCCCCCCCCTGGCCAGCGGCGGACGGGCCAGCCAGGGCGGCCTCGGGCACCGTACTCTGCCCGGTGTGG	Cassette13_8
ACCGATATCCTGGCCTTGGGCCGCCCCAGCGTGGCGCGGGCCCGCCCCCCGCGCCGCCAACCGAGGGCGCCGTCGAGCCGCGGGCCCCCCCCTGGCCAGCGGCTGACGGGCCAGCCAGGGCGGCCTCGGGCACCGTACTCTGCCCGGTGTGG	Cassette13_8
ACCGATATCCTGGCCTTGGGCCGCCCCAGCGTGGCGCGGGCCCGCCCCCCGCGCCGCCAACCGAGGGCGCCGTCGAGCCGCGGGCCCCCCCCTGGCTCGCAGCGGGAGGGCCAGCCAGGGCGGCCTCGGGCACCGTACTCTGCCCGGTGTGG	Cassette14_1
ACCGATATCCTGGCCTTGGGCCGCCCCAGCGTGGCGCGGGCCCGCCCCCCGCGCCGCCAACCGAGGGCGCCGTCGAGCCGCGGGCCCCCCCCTGGCTCGCAGCGTGAGGGCCAGCCAGGGCGGCCTCGGGCACCGTACTCTGCCCGGTGTGG	Cassette14_1
ACCGATATCCTGGCCTTGGGCCGCCCCAGCGTGGCGCGGGCCCGCCCCCCGCGCCGCCAACCGAGGGCGCCGTCGAGCCGCGGGCCCCCCCCTGGCTCGCAGCGAGCAGGCCAGCCAGGGCGGCCTCGGGCACCGTACTCTGCCCGGTGTGG	Cassette14_2
ACCGATATCCTGGCCTTGGGCCGCCCCAGCGTGGCGCGGGCCCGCCCCCCGCGCCGCCAACCGAGGGCGCCGTCGAGCCGCGGGCCCCCCCCTGGCTCGCAGCGATCAGGCCAGCCAGGGCGGCCTCGGGCACCGTACTCTGCCCGGTGTGG	Cassette14_2
ACCGATATCCTGGCCTTGGGCCGCCCCAGCGTGGCGCGGGCCCGCCCCCCGCGCCGCCAACCGAGGGCGCCGTCGAGCCGCGGGCCCCCCCCTGGCTCGCAGCGAAGGAGCCAGCCAGGGCGGCCTCGGGCACCGTACTCTGCCCGGTGTGG	Cassette14_3
ACCGATATCCTGGCCTTGGGCCGCCCCAGCGTGGCGCGGGCCCGCCCCCCGCGCCGCCAACCGAGGGCGCCGTCGAGCCGCGGGCCCCCCCCTGGCTCGCAGCGAATGAGCCAGCCAGGGCGGCCTCGGGCACCGTACTCTGCCCGGTGTGG	Cassette14_3
ACCGATATCCTGGCCTTGGGCCGCCCCAGCGTGGCGCGGGCCCGCCCCCCGCGCCGCCAACCGAGGGCGCCGTCGAGCCGCGGGCCCCCCCCTGGCTCGCAGCGGGCGAGCCAGCCAGGGCGGCCTCGGGCACCGTACTCTGCCCGGTGTGG	Cassette14_4
ACCGATATCCTGGCCTTGGGCCGCCCCAGCGTGGCGCGGGCCCGCCCCCCGCGCCGCCAACCGAGGGCGCCGTCGAGCCGCGGGCCCCCCCCTGGCTCGCAGCGGGCTAGCCAGCCAGGGCGGCCTCGGGCACCGTACTCTGCCCGGTGTGG	Cassette14_4
ACCGATATCCTGGCCTTGGGCCGCCCCAGCGTGGCGCGGGCCCGCCCCCCGCGCCGCCAACCGAGGGCGCCGTCGAGCCGCGGGCCCCCCCCTGGCTCGCAGCGGAAAGGCCAGCCAGGGCGGCCTCGGGCACCGTACTCTGCCCGGTGTGG	Cassette14_5
ACCGATATCCTGGCCTTGGGCCGCCCCAGCGTGGCGCGGGCCCGCCCCCCGCGCCGCCAACCGAGGGCGCCGTCGAGCCGCGGGCCCCCCCCTGGCTCGCAGCGGAAATGCCAGCCAGGGCGGCCTCGGGCACCGTACTCTGCCCGGTGTGG	Cassette14_5
ACCGATATCCTGGCCTTGGGCCGCCCCAGCGTGGCGCGGGCCCGCCCCCCGCGCCGCCAACCGAGGGCGCCGTCGAGCCGCGGGCCCCCCCCTGGCTCGCAGCGAGAAAGCCAGCCAGGGCGGCCTCGGGCACCGTACTCTGCCCGGTGTGG	Cassette14_6
ACCGATATCCTGGCCTTGGGCCGCCCCAGCGTGGCGCGGGCCCGCCCCCCGCGCCGCCAACCGAGGGCGCCGTCGAGCCGCGGGCCCCCCCCTGGCTCGCAGCGAGAAATCCAGCCAGGGCGGCCTCGGGCACCGTACTCTGCCCGGTGTGG	Cassette14_6
ACCGATATCCTGGCCTTGGGCCGCCCCAGCGTGGCGCGGGCCCGCCCCCCGCGCCGCCAACCGAGGGCGCCGTCGAGCCGCGGGCCCCCCCCTGGCTCGCAGCGAGCGAAGCAGCCAGGGCGGCCTCGGGCACCGTACTCTGCCCGGTGTGG	Cassette14_7
ACCGATATCCTGGCCTTGGGCCGCCCCAGCGTGGCGCGGGCCCGCCCCCCGCGCCGCCAACCGAGGGCGCCGTCGAGCCGCGGGCCCCCCCCTGGCTCGCAGCGAGCGAATCAGCCAGGGCGGCCTCGGGCACCGTACTCTGCCCGGTGTGG	Cassette14_7
ACCGATATCCTGGCCTTGGGCCGCCCCAGCGTGGCGCGGGCCCGCCCCCCGCGCCGCCAACCGAGGGCGCCGTCGAGCCGCGGGCCCCCCCCTGGCTCGCAGCGAAAGGACGAGCCAGGGCGGCCTCGGGCACCGTACTCTGCCCGGTGTGG	Cassette14_8
ACCGATATCCTGGCCTTGGGCCGCCCCAGCGTGGCGCGGGCCCGCCCCCCGCGCCGCCAACCGAGGGCGCCGTCGAGCCGCGGGCCCCCCCCTGGCTCGCAGCGAAAGGACTAGCCAGGGCGGCCTCGGGCACCGTACTCTGCCCGGTGTGG	Cassette14_8
ACCGATATCCTGGCCTTGGGCCGCCCCAGCGTGGCGCGGGCCCGCCCCCCGCGCCGCCAACCGAGGGCGCCGTCGAGCCGCGGGCCCCCCCCTGGCTCGCAGCGGACGGGCCGCACAGGGCGGCCTCGGGCACCGTACTCTGCCCGGTGTGG	Cassette15_1
ACCGATATCCTGGCCTTGGGCCGCCCCAGCGTGGCGCGGGCCCGCCCCCCGCGCCGCCAACCGAGGGCGCCGTCGAGCCGCGGGCCCCCCCCTGGCTCGCAGCGGACGGGCCTCACAGGGCGGCCTCGGGCACCGTACTCTGCCCGGTGTGG	Cassette15_1
ACCGATATCCTGGCCTTGGGCCGCCCCAGCGTGGCGCGGGCCCGCCCCCCGCGCCGCCAACCGAGGGCGCCGTCGAGCCGCGGGCCCCCCCCTGGCTCGCAGCGGACGGGCCGGCAAGGGCGGCCTCGGGCACCGTACTCTGCCCGGTGTGG	Cassette15_2
ACCGATATCCTGGCCTTGGGCCGCCCCAGCGTGGCGCGGGCCCGCCCCCCGCGCCGCCAACCGAGGGCGCCGTCGAGCCGCGGGCCCCCCCCTGGCTCGCAGCGGACGGGCCGTCAAGGGCGGCCTCGGGCACCGTACTCTGCCCGGTGTGG	Cassette15_2
ACCGATATCCTGGCCTTGGGCCGCCCCAGCGTGGCGCGGGCCCGCCCCCCGCGCCGCCAACCGAGGGCGCCGTCGAGCCGCGGGCCCCCCCCTGGCTCGCAGCGGACGGGCCGGGCTGGGCGGCCTCGGGCACCGTACTCTGCCCGGTGTGG	Cassette15_3
ACCGATATCCTGGCCTTGGGCCGCCCCAGCGTGGCGCGGGCCCGCCCCCCGCGCCGCCAACCGAGGGCGCCGTCGAGCCGCGGGCCCCCCCCTGGCTCGCAGCGGACGGGCCGGTCTGGGCGGCCTCGGGCACCGTACTCTGCCCGGTGTGG	Cassette15_3
ACCGATATCCTGGCCTTGGGCCGCCCCAGCGTGGCGCGGGCCCGCCCCCCGCGCCGCCAACCGAGGGCGCCGTCGAGCCGCGGGCCCCCCCCTGGCTCGCAGCGGACGGGCCACCGTGGGCGGCCTCGGGCACCGTACTCTGCCCGGTGTGG	Cassette15_4
ACCGATATCCTGGCCTTGGGCCGCCCCAGCGTGGCGCGGGCCCGCCCCCCGCGCCGCCAACCGAGGGCGCCGTCGAGCCGCGGGCCCCCCCCTGGCTCGCAGCGGACGGGCCACCTTGGGCGGCCTCGGGCACCGTACTCTGCCCGGTGTGG	Cassette15_4
ACCGATATCCTGGCCTTGGGCCGCCCCAGCGTGGCGCGGGCCCGCCCCCCGCGCCGCCAACCGAGGGCGCCGTCGAGCCGCGGGCCCCCCCCTGGCTCGCAGCGGACGGGCCAGAAGGGGCGGCCTCGGGCACCGTACTCTGCCCGGTGTGG	Cassette15_5
ACCGATATCCTGGCCTTGGGCCGCCCCAGCGTGGCGCGGGCCCGCCCCCCGCGCCGCCAACCGAGGGCGCCGTCGAGCCGCGGGCCCCCCCCTGGCTCGCAGCGGACGGGCCAGAATGGGCGGCCTCGGGCACCGTACTCTGCCCGGTGTGG	Cassette15_5
ACCGATATCCTGGCCTTGGGCCGCCCCAGCGTGGCGCGGGCCCGCCCCCCGCGCCGCCAACCGAGGGCGCCGTCGAGCCGCGGGCCCCCCCCTGGCTCGCAGCGGACGGGCCGCAATGGGCGGCCTCGGGCACCGTACTCTGCCCGGTGTGG	Cassette15_6
ACCGATATCCTGGCCTTGGGCCGCCCCAGCGTGGCGCGGGCCCGCCCCCCGCGCCGCCAACCGAGGGCGCCGTCGAGCCGCGGGCCCCCCCCTGGCTCGCAGCGGACGGGCCGCAATTGGCGGCCTCGGGCACCGTACTCTGCCCGGTGTGG	Cassette15_6
ACCGATATCCTGGCCTTGGGCCGCCCCAGCGTGGCGCGGGCCCGCCCCCCGCGCCGCCAACCGAGGGCGCCGTCGAGCCGCGGGCCCCCCCCTGGCTCGCAGCGGACGGGCCGCCCTAGGCGGCCTCGGGCACCGTACTCTGCCCGGTGTGG	Cassette15_7
ACCGATATCCTGGCCTTGGGCCGCCCCAGCGTGGCGCGGGCCCGCCCCCCGCGCCGCCAACCGAGGGCGCCGTCGAGCCGCGGGCCCCCCCCTGGCTCGCAGCGGACGGGCCGCCCTATGCGGCCTCGGGCACCGTACTCTGCCCGGTGTGG	Cassette15_7
ACCGATATCCTGGCCTTGGGCCGCCCCAGCGTGGCGCGGGCCCGCCCCCCGCGCCGCCAACCGAGGGCGCCGTCGAGCCGCGGGCCCCCCCCTGGCTCGCAGCGGACGGGCCGGCCAAGGCGGCCTCGGGCACCGTACTCTGCCCGGTGTGG	Cassette15_8
ACCGATATCCTGGCCTTGGGCCGCCCCAGCGTGGCGCGGGCCCGCCCCCCGCGCCGCCAACCGAGGGCGCCGTCGAGCCGCGGGCCCCCCCCTGGCTCGCAGCGGACGGGCCGGCCAAGTCGGCCTCGGGCACCGTACTCTGCCCGGTGTGG	Cassette15_8
ACCGATATCCTGGCCTTGGGCCGCCCCAGCGTGGCGCGGGCCCGCCCCCCGCGCCGCCAACCGAGGGCGCCGTCGAGCCGCGGGCCCCCCCCTGGCTCGCAGCGGACGGGCCAGCCAGGGGCACCTCGGGCACCGTACTCTGCCCGGTGTGG	Cassette16_1
ACCGATATCCTGGCCTTGGGCCGCCCCAGCGTGGCGCGGGCCCGCCCCCCGCGCCGCCAACCGAGGGCGCCGTCGAGCCGCGGGCCCCCCCCTGGCTCGCAGCGGACGGGCCAGCCAGGGTCACCTCGGGCACCGTACTCTGCCCGGTGTGG	Cassette16_1
ACCGATATCCTGGCCTTGGGCCGCCCCAGCGTGGCGCGGGCCCGCCCCCCGCGCCGCCAACCGAGGGCGCCGTCGAGCCGCGGGCCCCCCCCTGGCTCGCAGCGGACGGGCCAGCCAGGGTGGACTCGGGCACCGTACTCTGCCCGGTGTGG	Cassette16_2
ACCGATATCCTGGCCTTGGGCCGCCCCAGCGTGGCGCGGGCCCGCCCCCCGCGCCGCCAACCGAGGGCGCCGTCGAGCCGCGGGCCCCCCCCTGGCTCGCAGCGGACGGGCCAGCCAGGGTTGACTCGGGCACCGTACTCTGCCCGGTGTGG	Cassette16_2
ACCGATATCCTGGCCTTGGGCCGCCCCAGCGTGGCGCGGGCCCGCCCCCCGCGCCGCCAACCGAGGGCGCCGTCGAGCCGCGGGCCCCCCCCTGGCTCGCAGCGGACGGGCCAGCCAGGGTGGCTTCGGGCACCGTACTCTGCCCGGTGTGG	Cassette16_3
ACCGATATCCTGGCCTTGGGCCGCCCCAGCGTGGCGCGGGCCCGCCCCCCGCGCCGCCAACCGAGGGCGCCGTCGAGCCGCGGGCCCCCCCCTGGCTCGCAGCGGACGGGCCAGCCAGGGTGTCTTCGGGCACCGTACTCTGCCCGGTGTGG	Cassette16_3
ACCGATATCCTGGCCTTGGGCCGCCCCAGCGTGGCGCGGGCCCGCCCCCCGCGCCGCCAACCGAGGGCGCCGTCGAGCCGCGGGCCCCCCCCTGGCTCGCAGCGGACGGGCCAGCCAGGGCCGGTTCGGGCACCGTACTCTGCCCGGTGTGG	Cassette16_4
ACCGATATCCTGGCCTTGGGCCGCCCCAGCGTGGCGCGGGCCCGCCCCCCGCGCCGCCAACCGAGGGCGCCGTCGAGCCGCGGGCCCCCCCCTGGCTCGCAGCGGACGGGCCAGCCAGGGCCGTTTCGGGCACCGTACTCTGCCCGGTGTGG	Cassette16_4
ACCGATATCCTGGCCTTGGGCCGCCCCAGCGTGGCGCGGGCCCGCCCCCCGCGCCGCCAACCGAGGGCGCCGTCGAGCCGCGGGCCCCCCCCTGGCTCGCAGCGGACGGGCCAGCCAGGGCGAAGTCGGGCACCGTACTCTGCCCGGTGTGG	Cassette16_5
ACCGATATCCTGGCCTTGGGCCGCCCCAGCGTGGCGCGGGCCCGCCCCCCGCGCCGCCAACCGAGGGCGCCGTCGAGCCGCGGGCCCCCCCCTGGCTCGCAGCGGACGGGCCAGCCAGGGCGAATTCGGGCACCGTACTCTGCCCGGTGTGG	Cassette16_5
ACCGATATCCTGGCCTTGGGCCGCCCCAGCGTGGCGCGGGCCCGCCCCCCGCGCCGCCAACCGAGGGCGCCGTCGAGCCGCGGGCCCCCCCCTGGCTCGCAGCGGACGGGCCAGCCAGGGTCAATGCGGGCACCGTACTCTGCCCGGTGTGG	Cassette16_6
ACCGATATCCTGGCCTTGGGCCGCCCCAGCGTGGCGCGGGCCCGCCCCCCGCGCCGCCAACCGAGGGCGCCGTCGAGCCGCGGGCCCCCCCCTGGCTCGCAGCGGACGGGCCAGCCAGGGTCAATTCGGGCACCGTACTCTGCCCGGTGTGG	Cassette16_6
ACCGATATCCTGGCCTTGGGCCGCCCCAGCGTGGCGCGGGCCCGCCCCCCGCGCCGCCAACCGAGGGCGCCGTCGAGCCGCGGGCCCCCCCCTGGCTCGCAGCGGACGGGCCAGCCAGGGTCGCTAGGGGCACCGTACTCTGCCCGGTGTGG	Cassette16_7
ACCGATATCCTGGCCTTGGGCCGCCCCAGCGTGGCGCGGGCCCGCCCCCCGCGCCGCCAACCGAGGGCGCCGTCGAGCCGCGGGCCCCCCCCTGGCTCGCAGCGGACGGGCCAGCCAGGGTCGCTATGGGCACCGTACTCTGCCCGGTGTGG	Cassette16_7
ACCGATATCCTGGCCTTGGGCCGCCCCAGCGTGGCGCGGGCCCGCCCCCCGCGCCGCCAACCGAGGGCGCCGTCGAGCCGCGGGCCCCCCCCTGGCTCGCAGCGGACGGGCCAGCCAGGGTGACCACGGGCACCGTACTCTGCCCGGTGTGG	Cassette16_8
ACCGATATCCTGGCCTTGGGCCGCCCCAGCGTGGCGCGGGCCCGCCCCCCGCGCCGCCAACCGAGGGCGCCGTCGAGCCGCGGGCCCCCCCCTGGCTCGCAGCGGACGGGCCAGCCAGGGTGACCACTGGCACCGTACTCTGCCCGGTGTGG	Cassette16_8
ACCGATATCCTGGCCTTGGGCCGCCCCAGCGTGGCGCGGGCCCGCCCCCCGCGCCGCCAACCGAGGGCGCCGTCGAGCCGCGGGCCCCCCCCTGGCTCGCAGCGGACGGGCCAGCCAGGGCGGCCTCGGCAACCGTACTCTGCCCGGTGTGG	Cassette17_1
ACCGATATCCTGGCCTTGGGCCGCCCCAGCGTGGCGCGGGCCCGCCCCCCGCGCCGCCAACCGAGGGCGCCGTCGAGCCGCGGGCCCCCCCCTGGCTCGCAGCGGACGGGCCAGCCAGGGCGGCCTCGTCAACCGTACTCTGCCCGGTGTGG	Cassette17_1
ACCGATATCCTGGCCTTGGGCCGCCCCAGCGTGGCGCGGGCCCGCCCCCCGCGCCGCCAACCGAGGGCGCCGTCGAGCCGCGGGCCCCCCCCTGGCTCGCAGCGGACGGGCCAGCCAGGGCGGCCTCGAGCGCCGTACTCTGCCCGGTGTGG	Cassette17_2
ACCGATATCCTGGCCTTGGGCCGCCCCAGCGTGGCGCGGGCCCGCCCCCCGCGCCGCCAACCGAGGGCGCCGTCGAGCCGCGGGCCCCCCCCTGGCTCGCAGCGGACGGGCCAGCCAGGGCGGCCTCGATCGCCGTACTCTGCCCGGTGTGG	Cassette17_2
ACCGATATCCTGGCCTTGGGCCGCCCCAGCGTGGCGCGGGCCCGCCCCCCGCGCCGCCAACCGAGGGCGCCGTCGAGCCGCGGGCCCCCCCCTGGCTCGCAGCGGACGGGCCAGCCAGGGCGGCCTCGAGGAACGTACTCTGCCCGGTGTGG	Cassette17_3
ACCGATATCCTGGCCTTGGGCCGCCCCAGCGTGGCGCGGGCCCGCCCCCCGCGCCGCCAACCGAGGGCGCCGTCGAGCCGCGGGCCCCCCCCTGGCTCGCAGCGGACGGGCCAGCCAGGGCGGCCTCGAGTAACGTACTCTGCCCGGTGTGG	Cassette17_3
ACCGATATCCTGGCCTTGGGCCGCCCCAGCGTGGCGCGGGCCCGCCCCCCGCGCCGCCAACCGAGGGCGCCGTCGAGCCGCGGGCCCCCCCCTGGCTCGCAGCGGACGGGCCAGCCAGGGCGGCCTCGGCCGACGTACTCTGCCCGGTGTGG	Cassette17_4
ACCGATATCCTGGCCTTGGGCCGCCCCAGCGTGGCGCGGGCCCGCCCCCCGCGCCGCCAACCGAGGGCGCCGTCGAGCCGCGGGCCCCCCCCTGGCTCGCAGCGGACGGGCCAGCCAGGGCGGCCTCGGCCTACGTACTCTGCCCGGTGTGG	Cassette17_4
ACCGATATCCTGGCCTTGGGCCGCCCCAGCGTGGCGCGGGCCCGCCCCCCGCGCCGCCAACCGAGGGCGCCGTCGAGCCGCGGGCCCCCCCCTGGCTCGCAGCGGACGGGCCAGCCAGGGCGGCCTCGGGAGGCGTACTCTGCCCGGTGTGG	Cassette17_5
ACCGATATCCTGGCCTTGGGCCGCCCCAGCGTGGCGCGGGCCCGCCCCCCGCGCCGCCAACCGAGGGCGCCGTCGAGCCGCGGGCCCCCCCCTGGCTCGCAGCGGACGGGCCAGCCAGGGCGGCCTCGGGAGTCGTACTCTGCCCGGTGTGG	Cassette17_5
ACCGATATCCTGGCCTTGGGCCGCCCCAGCGTGGCGCGGGCCCGCCCCCCGCGCCGCCAACCGAGGGCGCCGTCGAGCCGCGGGCCCCCCCCTGGCTCGCAGCGGACGGGCCAGCCAGGGCGGCCTCGACAGAGGTACTCTGCCCGGTGTGG	Cassette17_6
ACCGATATCCTGGCCTTGGGCCGCCCCAGCGTGGCGCGGGCCCGCCCCCCGCGCCGCCAACCGAGGGCGCCGTCGAGCCGCGGGCCCCCCCCTGGCTCGCAGCGGACGGGCCAGCCAGGGCGGCCTCGACAGATGTACTCTGCCCGGTGTGG	Cassette17_6
ACCGATATCCTGGCCTTGGGCCGCCCCAGCGTGGCGCGGGCCCGCCCCCCGCGCCGCCAACCGAGGGCGCCGTCGAGCCGCGGGCCCCCCCCTGGCTCGCAGCGGACGGGCCAGCCAGGGCGGCCTCGACCAAAGTACTCTGCCCGGTGTGG	Cassette17_7
ACCGATATCCTGGCCTTGGGCCGCCCCAGCGTGGCGCGGGCCCGCCCCCCGCGCCGCCAACCGAGGGCGCCGTCGAGCCGCGGGCCCCCCCCTGGCTCGCAGCGGACGGGCCAGCCAGGGCGGCCTCGACCAAATTACTCTGCCCGGTGTGG	Cassette17_7
ACCGATATCCTGGCCTTGGGCCGCCCCAGCGTGGCGCGGGCCCGCCCCCCGCGCCGCCAACCGAGGGCGCCGTCGAGCCGCGGGCCCCCCCCTGGCTCGCAGCGGACGGGCCAGCCAGGGCGGCCTCGAGCGAAGGACTCTGCCCGGTGTGG	Cassette17_8
ACCGATATCCTGGCCTTGGGCCGCCCCAGCGTGGCGCGGGCCCGCCCCCCGCGCCGCCAACCGAGGGCGCCGTCGAGCCGCGGGCCCCCCCCTGGCTCGCAGCGGACGGGCCAGCCAGGGCGGCCTCGAGCGAAGTACTCTGCCCGGTGTGG	Cassette17_8
ACCGATATCCTGGCCTTGGGCCGCCCCAGCGTGGCGCGGGCCCGCCCCCCGCGCCGCCAACCGAGGGCGCCGTCGAGCCGCGGGCCCCCCCCTGGCTCGCAGCGGACGGGCCAGCCAGGGCGGCCTCGGGCACCGTGAGCTGCCCGGTGTGG	Cassette18_1
ACCGATATCCTGGCCTTGGGCCGCCCCAGCGTGGCGCGGGCCCGCCCCCCGCGCCGCCAACCGAGGGCGCCGTCGAGCCGCGGGCCCCCCCCTGGCTCGCAGCGGACGGGCCAGCCAGGGCGGCCTCGGGCACCGTTAGCTGCCCGGTGTGG	Cassette18_1
ACCGATATCCTGGCCTTGGGCCGCCCCAGCGTGGCGCGGGCCCGCCCCCCGCGCCGCCAACCGAGGGCGCCGTCGAGCCGCGGGCCCCCCCCTGGCTCGCAGCGGACGGGCCAGCCAGGGCGGCCTCGGGCACCGTGGTATGCCCGGTGTGG	Cassette18_2
ACCGATATCCTGGCCTTGGGCCGCCCCAGCGTGGCGCGGGCCCGCCCCCCGCGCCGCCAACCGAGGGCGCCGTCGAGCCGCGGGCCCCCCCCTGGCTCGCAGCGGACGGGCCAGCCAGGGCGGCCTCGGGCACCGTGTTATGCCCGGTGTGG	Cassette18_2
ACCGATATCCTGGCCTTGGGCCGCCCCAGCGTGGCGCGGGCCCGCCCCCCGCGCCGCCAACCGAGGGCGCCGTCGAGCCGCGGGCCCCCCCCTGGCTCGCAGCGGACGGGCCAGCCAGGGCGGCCTCGGGCACCGTGCGCCGCCCGGTGTGG	Cassette18_3
ACCGATATCCTGGCCTTGGGCCGCCCCAGCGTGGCGCGGGCCCGCCCCCCGCGCCGCCAACCGAGGGCGCCGTCGAGCCGCGGGCCCCCCCCTGGCTCGCAGCGGACGGGCCAGCCAGGGCGGCCTCGGGCACCGTGCTCCGCCCGGTGTGG	Cassette18_3
ACCGATATCCTGGCCTTGGGCCGCCCCAGCGTGGCGCGGGCCCGCCCCCCGCGCCGCCAACCGAGGGCGCCGTCGAGCCGCGGGCCCCCCCCTGGCTCGCAGCGGACGGGCCAGCCAGGGCGGCCTCGGGCACCGTAATGCGCCCGGTGTGG	Cassette18_4
ACCGATATCCTGGCCTTGGGCCGCCCCAGCGTGGCGCGGGCCCGCCCCCCGCGCCGCCAACCGAGGGCGCCGTCGAGCCGCGGGCCCCCCCCTGGCTCGCAGCGGACGGGCCAGCCAGGGCGGCCTCGGGCACCGTAATTCGCCCGGTGTGG	Cassette18_4
ACCGATATCCTGGCCTTGGGCCGCCCCAGCGTGGCGCGGGCCCGCCCCCCGCGCCGCCAACCGAGGGCGCCGTCGAGCCGCGGGCCCCCCCCTGGCTCGCAGCGGACGGGCCAGCCAGGGCGGCCTCGGGCACCGTACGAGGCCCGGTGTGG	Cassette18_5
ACCGATATCCTGGCCTTGGGCCGCCCCAGCGTGGCGCGGGCCCGCCCCCCGCGCCGCCAACCGAGGGCGCCGTCGAGCCGCGGGCCCCCCCCTGGCTCGCAGCGGACGGGCCAGCCAGGGCGGCCTCGGGCACCGTACGATGCCCGGTGTGG	Cassette18_5
ACCGATATCCTGGCCTTGGGCCGCCCCAGCGTGGCGCGGGCCCGCCCCCCGCGCCGCCAACCGAGGGCGCCGTCGAGCCGCGGGCCCCCCCCTGGCTCGCAGCGGACGGGCCAGCCAGGGCGGCCTCGGGCACCGTGAGACGCCCGGTGTGG	Cassette18_6
ACCGATATCCTGGCCTTGGGCCGCCCCAGCGTGGCGCGGGCCCGCCCCCCGCGCCGCCAACCGAGGGCGCCGTCGAGCCGCGGGCCCCCCCCTGGCTCGCAGCGGACGGGCCAGCCAGGGCGGCCTCGGGCACCGTGAGACTCCCGGTGTGG	Cassette18_6
ACCGATATCCTGGCCTTGGGCCGCCCCAGCGTGGCGCGGGCCCGCCCCCCGCGCCGCCAACCGAGGGCGCCGTCGAGCCGCGGGCCCCCCCCTGGCTCGCAGCGGACGGGCCAGCCAGGGCGGCCTCGGGCACCGTGATCCCGCCGGTGTGG	Cassette18_7
ACCGATATCCTGGCCTTGGGCCGCCCCAGCGTGGCGCGGGCCCGCCCCCCGCGCCGCCAACCGAGGGCGCCGTCGAGCCGCGGGCCCCCCCCTGGCTCGCAGCGGACGGGCCAGCCAGGGCGGCCTCGGGCACCGTGATCCCTCCGGTGTGG	Cassette18_7
ACCGATATCCTGGCCTTGGGCCGCCCCAGCGTGGCGCGGGCCCGCCCCCCGCGCCGCCAACCGAGGGCGCCGTCGAGCCGCGGGCCCCCCCCTGGCTCGCAGCGGACGGGCCAGCCAGGGCGGCCTCGGGCACCGTGCTACCCGCGGTGTGG	Cassette18_8
ACCGATATCCTGGCCTTGGGCCGCCCCAGCGTGGCGCGGGCCCGCCCCCCGCGCCGCCAACCGAGGGCGCCGTCGAGCCGCGGGCCCCCCCCTGGCTCGCAGCGGACGGGCCAGCCAGGGCGGCCTCGGGCACCGTGCTACCCTCGGTGTGG	Cassette18_8
ACCGATATCCTGGCCTTGGGCCGCCCCAGCGTGGCGCGGGCCCGCCCCCCGCGCCGCCAACCGAGGGCGCCGTCGAGCCGCGGGCCCCCCCCTGGCTCGCAGCGGACGGGCCAGCCAGGGCGGCCTCGGGCACCGTACTCTGCCGAGGGTGG	Cassette19_1
ACCGATATCCTGGCCTTGGGCCGCCCCAGCGTGGCGCGGGCCCGCCCCCCGCGCCGCCAACCGAGGGCGCCGTCGAGCCGCGGGCCCCCCCCTGGCTCGCAGCGGACGGGCCAGCCAGGGCGGCCTCGGGCACCGTACTCTGCCTAGGGTGG	Cassette19_1
ACCGATATCCTGGCCTTGGGCCGCCCCAGCGTGGCGCGGGCCCGCCCCCCGCGCCGCCAACCGAGGGCGCCGTCGAGCCGCGGGCCCCCCCCTGGCTCGCAGCGGACGGGCCAGCCAGGGCGGCCTCGGGCACCGTACTCTGCCAGGTATGG	Cassette19_2
ACCGATATCCTGGCCTTGGGCCGCCCCAGCGTGGCGCGGGCCCGCCCCCCGCGCCGCCAACCGAGGGCGCCGTCGAGCCGCGGGCCCCCCCCTGGCTCGCAGCGGACGGGCCAGCCAGGGCGGCCTCGGGCACCGTACTCTGCCATGTATGG	Cassette19_2
ACCGATATCCTGGCCTTGGGCCGCCCCAGCGTGGCGCGGGCCCGCCCCCCGCGCCGCCAACCGAGGGCGCCGTCGAGCCGCGGGCCCCCCCCTGGCTCGCAGCGGACGGGCCAGCCAGGGCGGCCTCGGGCACCGTACTCTGCCCGGGATGG	Cassette19_3
ACCGATATCCTGGCCTTGGGCCGCCCCAGCGTGGCGCGGGCCCGCCCCCCGCGCCGCCAACCGAGGGCGCCGTCGAGCCGCGGGCCCCCCCCTGGCTCGCAGCGGACGGGCCAGCCAGGGCGGCCTCGGGCACCGTACTCTGCCCGTGATGG	Cassette19_3
ACCGATATCCTGGCCTTGGGCCGCCCCAGCGTGGCGCGGGCCCGCCCCCCGCGCCGCCAACCGAGGGCGCCGTCGAGCCGCGGGCCCCCCCCTGGCTCGCAGCGGACGGGCCAGCCAGGGCGGCCTCGGGCACCGTACTCTGCCCAGGACGG	Cassette19_4
ACCGATATCCTGGCCTTGGGCCGCCCCAGCGTGGCGCGGGCCCGCCCCCCGCGCCGCCAACCGAGGGCGCCGTCGAGCCGCGGGCCCCCCCCTGGCTCGCAGCGGACGGGCCAGCCAGGGCGGCCTCGGGCACCGTACTCTGCCCAGTACGG	Cassette19_4
ACCGATATCCTGGCCTTGGGCCGCCCCAGCGTGGCGCGGGCCCGCCCCCCGCGCCGCCAACCGAGGGCGCCGTCGAGCCGCGGGCCCCCCCCTGGCTCGCAGCGGACGGGCCAGCCAGGGCGGCCTCGGGCACCGTACTCTGCCAGGGGCGG	Cassette19_5
ACCGATATCCTGGCCTTGGGCCGCCCCAGCGTGGCGCGGGCCCGCCCCCCGCGCCGCCAACCGAGGGCGCCGTCGAGCCGCGGGCCCCCCCCTGGCTCGCAGCGGACGGGCCAGCCAGGGCGGCCTCGGGCACCGTACTCTGCCAGGGTCGG	Cassette19_5
ACCGATATCCTGGCCTTGGGCCGCCCCAGCGTGGCGCGGGCCCGCCCCCCGCGCCGCCAACCGAGGGCGCCGTCGAGCCGCGGGCCCCCCCCTGGCTCGCAGCGGACGGGCCAGCCAGGGCGGCCTCGGGCACCGTACTCTGCCCGGTAGAG	Cassette19_6
ACCGATATCCTGGCCTTGGGCCGCCCCAGCGTGGCGCGGGCCCGCCCCCCGCGCCGCCAACCGAGGGCGCCGTCGAGCCGCGGGCCCCCCCCTGGCTCGCAGCGGACGGGCCAGCCAGGGCGGCCTCGGGCACCGTACTCTGCCCGGTATAG	Cassette19_6
ACCGATATCCTGGCCTTGGGCCGCCCCAGCGTGGCGCGGGCCCGCCCCCCGCGCCGCCAACCGAGGGCGCCGTCGAGCCGCGGGCCCCCCCCTGGCTCGCAGCGGACGGGCCAGCCAGGGCGGCCTCGGGCACCGTACTCTGCCAAGTGCGG	Cassette19_7
ACCGATATCCTGGCCTTGGGCCGCCCCAGCGTGGCGCGGGCCCGCCCCCCGCGCCGCCAACCGAGGGCGCCGTCGAGCCGCGGGCCCCCCCCTGGCTCGCAGCGGACGGGCCAGCCAGGGCGGCCTCGGGCACCGTACTCTGCCAAGTGCTG	Cassette19_7
ACCGATATCCTGGCCTTGGGCCGCCCCAGCGTGGCGCGGGCCCGCCCCCCGCGCCGCCAACCGAGGGCGCCGTCGAGCCGCGGGCCCCCCCCTGGCTCGCAGCGGACGGGCCAGCCAGGGCGGCCTCGGGCACCGTACTCTGCCCGGGGTAG	Cassette19_8
ACCGATATCCTGGCCTTGGGCCGCCCCAGCGTGGCGCGGGCCCGCCCCCCGCGCCGCCAACCGAGGGCGCCGTCGAGCCGCGGGCCCCCCCCTGGCTCGCAGCGGACGGGCCAGCCAGGGCGGCCTCGGGCACCGTACTCTGCCCGGGGTAT	Cassette19_8
ACCGATATCCTGGCCTTGGGCCGCCCCAGCGTGGCGCGGGCCCGCCCCCCGCGCCGCCAACCGAGGGCGCCGTCGAGCCGCGGGCCCCCCCCTGGCTCGCAGCGGACGGGCCAGCCAGGGCGGCCTCGGGCACCGTACTCTGCCCGGTGTGG	WT
